30 100
CTCTTTACATCGTGATACACATTAGCATGC|AGACCGGCTCTTTACATCGTGATACACATT
TTTGTCTCTTAGAGCGCTTTCAGTGCCACT|TCAGTTTTACCGGGGTTCCTGGGGTTACAG
TAGTCCATTTTTATTGCGTGTTTGTCTCTT|TCGGAGATGACAGGAACGGTTCAGTTTTAC
AACTAGTGTCTTCATGATGAGACAGTTCGT|CTTTACATCGTGATACACATTAGCCGGCTC
CATTAGGATCCCTCAGTTATACCGGCTCTT|GGTTTTGAGCTCCAACCGGCTCTTTACATC
CTTCAGAGTGCTGAGGGCTATATTTAGACG|GAGGATCTTCCACAGACACGTCTTCCGGAC
ATAAGACTTTTCAGTCTCGTCCCGACTGCG|ATACACAACCGGCTCTTTACATCGTGATAC
CCGGCTCTTTACATCGTGATACACATTAGC|GGCTCTTTACATCGTGATACACATTAGTTT
CTTTACATCGTGATACACAACCGGCTCTTT|ATACACATTAGGATCGGCTCGGTTAAGGAT
AGAGATCGATTATTATCAGGCGTCGCTAAT|GCTCATATCCGATCGGCGCATTTTGGGAAT
GCTCTTTAACCGGCTCTTTACATCGTGATA|GGTACGACCGGCTCTTTACATCGTGATACA
AGACACGTCTTCCGGACGGGCAGTTTAACG|GGTAGGTGACCTCACCGGCTCTTTACATCG
ATGAGCCGACTCGCTCATATCCGATCGGCG|TTCCCGTGGCGACCGGCTCTTTAACCGGCT
GTGATACACATTAGACCGGTGACCATACAG|GACTGCGATATGCAACCGGCTCTTTACATC
CCCACTTCAGACCGGCTCTTTACATCGTGA|GCTATAAGACTTTTCAGTCTCGTCCCGACT
GTGCGAGAGATCGATTATTATCAGGCGTCG|GACTCGCTCATATCCGATCGGCGCATTTTG
TTTACATCGTGATACACATTAGCACCGGCT|CTGATCGAGAGCAGGTCAACCGGCTCTTTA
CCGGCTCTTTACATCGTGATACACATTAGC|CTATATTTAGACGCAGGCGCCGTGGCCCAC
AACCGGCTCTTTACATCGTGATACACATTA|TTTACATCGTGATACACATTAGGTATGAGC
CGCCCCACGCTAATGACGATGCGCTGTGGG|GTAGCTTTATAGAGGTTTCCGTCGCGGCGA
GTTCTACGGGGGAGACTAGCTAATGATTCC|CGCGTCCTCACTCAGTGCGTCGCCGAAGCT
CAGGCGCCGTGGCCCACTTCAGACCGGCTC|GGGCAGTTTAACGCTATAAGACTTTTCAGT
CGCCGACCGTGGGCATGCTATATGTCTCTT|GGCCACTTGCTTGCCGAGACTTATCTTGGA
ATTTCATGCGTTAATGTCGGTATGTCAGCA|ATACACATTAGCATCGTGATACACATTAGC
GCTCTTTACATCGTGATACACATTAGTTAG|TAAGGATTGTAGACGTCGAGATTTCCCTCC
AGGAGAGGGGGGAGCTGCTTTCATGCGGTT|TCGTGATACACATTAGCACCGGCTCCCACC
ATGCTATATGTCTCTTAATCCGCGTCCTCA|CGAGACTTATCTTGGAGGTCTCACTGGCGG
CGGCTCTTTAACCGGCTCTTTACATCGTGA|CGGGTACGACCGGCTCTTTACATCGTGATA
GGACGGGCAGTTTAACGCTATAAGACTTTT|ACCGGCTCTTTACATCGTGATACACAACCG
TGATACACATTAGGATCCCTCAGTTATACC|CGCTGTGGGTTTTGAGCTCCAACCGGCTCT
GGGGGAGACTAGCTAATGATTCCTGGCTAG|TCACTCAGTGCGTCGCCGAAGCTCCAGTCG
GACACGTCTTCCGGACGGGCAGTTTAACGC|GTAGGTGACCTCACCGGCTCTTTACATCGT
CATTAGTTAGTGCCCTGATCGAGAGCAGGT|ATTTCCCTCCTGCATGTATCGATAGTTCTA
TCTACGGGGGAGACTAGCTAATGATTCCTG|CGTCCTCACTCAGTGCGTCGCCGAAGCTCC
ATACCTTCACCTACTTACCCTCCGCATCTC|TCGCTAATCGTTCCAGGCAATCAGGCGACT
GCAATCAGGCGACTAGTAGCTTTATAGAGG|CGTTAATGTCGGTATGTCAGCATCTTACGG
TCCTGCTGTGCGCCGACCGTGGGCATGCTA|CATGGAGCGTGGCCACTTGCTTGCCGAGAC
CGGCTCTTTACATCGTGATACACATTAGTT|ATACAGGAGAGGGGGGAGCTGCTTTCATGC
ACCGGCTCTTTACATCGTGATACACAACCG|CATCGTGATACACATTAGGATCGGCTCGGT
GTGATACACATTAGTTAGTGCCCTGATCGA|ACGTCGAGATTTCCCTCCTGCATGTATCGA
CACCGGCTCTTTACATCGTGATACACAACC|ACATCGTGATACACATTAGGATCGGCTCGG
GGCTTCAGAGTGCTGAGGGCTATATTTAGA|ACGAGGATCTTCCACAGACACGTCTTCCGG
TTAGCACCGGCTCCCACCGCAATTGAGCGA|ACCGGCTCTTTACATCGTGATACACATTAG
TACATCGTGATACACATTAGCACCGGCTCC|GATCGAGAGCAGGTCAACCGGCTCTTTACA
CCGGCTCTTTACATCGTGATACACATTAGG|GATGAGACAGTTCGTGCAGTGCAGATGTCA
GCTTCAGAGTGCTGAGGGCTATATTTAGAC|CGAGGATCTTCCACAGACACGTCTTCCGGA
ACCGTGGGCATGCTATATGTCTCTTAATCC|CTTGCTTGCCGAGACTTATCTTGGAGGTCT
CCCGACTGCGATATGCAACCGGCTCTTTAC|ATCGTGATACACATTAGTTAGTGCCCTGAT
CGACCGTGGGCATGCTATATGTCTCTTAAT|CACTTGCTTGCCGAGACTTATCTTGGAGGT
GGAATATTTCATGCGTTAATGTCGGTATGT|TCGTGATACACATTAGCATCGTGATACACA
GACCGGCTCTTTACATCGTGATACACATTA|ATGATGAGACAGTTCGTGCAGTGCAGATGT
CGGTATGTCAGCATCTTACGGTATCAACTA|GATACACATTAGCGAGCAACCGGCTCTTTA
TTCTACGGGGGAGACTAGCTAATGATTCCT|GCGTCCTCACTCAGTGCGTCGCCGAAGCTC
CTTAGAGCGCTTTCAGTGCCACTAGTCCTG|TACCGGGGTTCCTGGGGTTACAGCTCATGG
TCCCGACTGCGATATGCAACCGGCTCTTTA|CATCGTGATACACATTAGTTAGTGCCCTGA
AGGTGCGAGAGATCGATTATTATCAGGCGT|CCGACTCGCTCATATCCGATCGGCGCATTT
AGGGTGTACTTCACCTCCAGCATATACCTT|GAGAGATCGATTATTATCAGGCGTCGCTAA
ATCGTGATACACATTAGGATCGGCTCGGTT|GTCTCTTAGAGCGCTTTCAGTGCCACTAGT
CTTTACATCGTGATACACATTAGTTTAGAG|GGAGAGGGGGGAGCTGCTTTCATGCGGTTC
GACTAGTAGCTTTATAGAGGTTTCCGTCGC|GGTATGTCAGCATCTTACGGTATCAACTAG
ATCGTGATACACATTAGGGTGTACTTCACC|ATACACATTAGGTGCGAGAGATCGATTATT
GGGTACGACCGGCTCTTTACATCGTGATAC|CCGGTGACCATACAGGAGAGGGGGGAGCTG
ATCGTGATACACATTAGCACCGGCTCCCAC|CGAGAGCAGGTCAACCGGCTCTTTACATCG
TCGTGATACACATTAGCACCGGCTCCCACC|GAGAGCAGGTCAACCGGCTCTTTACATCGT
GCATTTTGGGAATATTTCATGCGTTAATGT|TCTTTACATCGTGATACACATTAGCATCGT
GACCGGTGACCATACAGGAGAGGGGGGAGC|AACCGGCTCTTTACATCGTGATACACATTA
ACCGGCTCTTTACATCGTGATACACATTAG|CGGCTCTTTACATCGTGATACACATTAGTT
TTAGGATCCCTCAGTTATACCGGCTCTTTA|TTTTGAGCTCCAACCGGCTCTTTACATCGT
AATTGAGCGAGTGGCGGTAGGTGACCTCAC|TACACATTAGGACTGTACCGGCTCTTTACA
GCGATAGACCGGCTCTTTACATCGTGATAC|GTCTTCATGATGAGACAGTTCGTGCAGTGC
TTACATCGTGATACACATTAGGATCCCTCA|TGACGATGCGCTGTGGGTTTTGAGCTCCAA
CGGCTCTTTACATCGTGATACACATTAGCA|TTCAGACCGGCTCTTTACATCGTGATACAC
ACCGGCTCTTTACATCGTGATACACATTAG|TTTTCAGTCTCGTCCCGACTGCGATATGCA
TCGTGATACACATTAGGTGCGAGAGATCGA|ACATTAGGTATGAGCCGACTCGCTCATATC
AGGACTGTACCGGCTCTTTACATCGTGATA|GTCCATTTTTATTGCGTGTTTGTCTCTTAG
TACCGGCTCTTTACATCGTGATACACATTA|CTCTTTACATCGTGATACACATTAGGTGCG
TTGTAGACGTCGAGATTTCCCTCCTGCATG|TGTGCGCCGACCGTGGGCATGCTATATGTC
AGCATGCACCGGGTACGACCGGCTCTTTAC|ACACATTAGACCGGTGACCATACAGGAGAG
ATGTATCGATAGTTCTACGGGGGAGACTAG|GTCTCTTAATCCGCGTCCTCACTCAGTGCG
GAGCTCCAACCGGCTCTTTACATCGTGATA|CCGGCTCTTTACATCGTGATACACATTAGG
GACTTTTCAGTCTCGTCCCGACTGCGATAT|ACAACCGGCTCTTTACATCGTGATACACAT
TCGTGATACACATTAGCATGCACCGGGTAC|CTTTACATCGTGATACACATTAGACCGGTG
CACATTAGGTGCGAGAGATCGATTATTATC|TATGAGCCGACTCGCTCATATCCGATCGGC
CTCTTTACATCGTGATACACATTAGGGTGT|ACATCGTGATACACATTAGGTGCGAGAGAT
TTTACATCGTGATACACATTAGCATCGTGA|TACATCGTGATACACATTAGTTTAGAGAGG
CAGTTTAACGCTATAAGACTTTTCAGTCTC|CTTTACATCGTGATACACAACCGGCTCTTT
ATACACATTAGTTAGTGCCCTGATCGAGAG|TCGAGATTTCCCTCCTGCATGTATCGATAG
TTTTATTGCGTGTTTGTCTCTTAGAGCGCT|GACAGGAACGGTTCAGTTTTACCGGGGTTC
CCCTGATCGAGAGCAGGTCAACCGGCTCTT|CATGTATCGATAGTTCTACGGGGGAGACTA
TACACATTAGACCGGTGACCATACAGGAGA|GCGATATGCAACCGGCTCTTTACATCGTGA
GTGGCCCACTTCAGACCGGCTCTTTACATC|TAACGCTATAAGACTTTTCAGTCTCGTCCC
ATCGTGATACACATTAGGATCCCTCAGTTA|GATGCGCTGTGGGTTTTGAGCTCCAACCGG
CATTAGCGAGCAACCGGCTCTTTACATCGT|AGAGTGCTGAGGGCTATATTTAGACGCAGG
GGTAGGTGACCTCACCGGCTCTTTACATCG|TACCGGCTCTTTACATCGTGATACACATTA
ATTAGGATCCCTCAGTTATACCGGCTCTTT|GTTTTGAGCTCCAACCGGCTCTTTACATCG
TTATTATCAGGCGTCGCTAATCGTTCCAGG|CGATCGGCGCATTTTGGGAATATTTCATGC
CGTGATACACATTAGCATGCACCGGGTACG|TTTACATCGTGATACACATTAGACCGGTGA
TTTACATCGTGATACACATTAGTTAGTGCC|GATTGTAGACGTCGAGATTTCCCTCCTGCA
TCAGGCGACTAGTAGCTTTATAGAGGTTTC|AATGTCGGTATGTCAGCATCTTACGGTATC
CGTGTTTGTCTCTTAGAGCGCTTTCAGTGC|CGGTTCAGTTTTACCGGGGTTCCTGGGGTT
TACGACCGGCTCTTTACATCGTGATACACA|GTGACCATACAGGAGAGGGGGGAGCTGCTT
TGTATCGATAGTTCTACGGGGGAGACTAGC|TCTCTTAATCCGCGTCCTCACTCAGTGCGT
TCGTGATACACATTAGCGAGCAACCGGCTC|GAGAGGCTTCAGAGTGCTGAGGGCTATATT
TACCTTCACCTACTTACCCTCCGCATCTCC|CGCTAATCGTTCCAGGCAATCAGGCGACTA
CATCGTGATACACATTAGCACCGGCTCCCA|TCGAGAGCAGGTCAACCGGCTCTTTACATC
GGCGACCGGCTCTTTAACCGGCTCTTTACA|ATGCACCGGGTACGACCGGCTCTTTACATC
ACACATTAGACCGGTGACCATACAGGAGAG|CGATATGCAACCGGCTCTTTACATCGTGAT
CTCCCGCCCCACGCTAATGACGATGCGCTG|ACTAGTAGCTTTATAGAGGTTTCCGTCGCG
TATACCTTCACCTACTTACCCTCCGCATCT|GTCGCTAATCGTTCCAGGCAATCAGGCGAC
TCGTGATACACATTAGGGTGTACTTCACCT|TACACATTAGGTGCGAGAGATCGATTATTA
GATACACATTAGTTTAGAGAGGCTTCAGAG|AGCTGCTTTCATGCGGTTCAACGAGGATCT
TGGCTAGTCCATTTTTATTGCGTGTTTGTC|CCAGTCGGAGATGACAGGAACGGTTCAGTT
TGTCACTTCCCGTGGCGACCGGCTCTTTAA|GATACACATTAGCATGCACCGGGTACGACC
TTACATCGTGATACACATTAGCATCGTGAT|ACATCGTGATACACATTAGTTTAGAGAGGC
GATACACAACCGGCTCTTTACATCGTGATA|GATCGGCTCGGTTAAGGATTGTAGACGTCG
ACCATACAGGAGAGGGGGGAGCTGCTTTCA|CTTTACATCGTGATACACATTAGCACCGGC
GTATCGATAGTTCTACGGGGGAGACTAGCT|CTCTTAATCCGCGTCCTCACTCAGTGCGTC
CGTGATACACATTAGGGTGTACTTCACCTC|ACACATTAGGTGCGAGAGATCGATTATTAT
ATTAGTTAGTGCCCTGATCGAGAGCAGGTC|TTTCCCTCCTGCATGTATCGATAGTTCTAC
ACACATTAGGTATGAGCCGACTCGCTCATA|GCAGATGTCACTTCCCGTGGCGACCGGCTC
CACCGGCTCCCACCGCAATTGAGCGAGTGG|GCTCTTTACATCGTGATACACATTAGGACT
ACATTAGCATCGTGATACACATTAGCGAGC|ATTAGTTTAGAGAGGCTTCAGAGTGCTGAG
GGAGCTGCTTTCATGCGGTTCAACGAGGAT|CATTAGCACCGGCTCCCACCGCAATTGAGC
GTGACCATACAGGAGAGGGGGGAGCTGCTT|GCTCTTTACATCGTGATACACATTAGCACC
CGGGGGAGACTAGCTAATGATTCCTGGCTA|CTCACTCAGTGCGTCGCCGAAGCTCCAGTC
AGGATTGTAGACGTCGAGATTTCCCTCCTG|CTGCTGTGCGCCGACCGTGGGCATGCTATA
ATCGGCTCGGTTAAGGATTGTAGACGTCGA|AGTGCCACTAGTCCTGCTGTGCGCCGACCG
TTCCGTCGCGGCGATAGACCGGCTCTTTAC|ATCAACTAGTGTCTTCATGATGAGACAGTT
CATCGTGATACACAACCGGCTCTTTACATC|CATTAGGATCGGCTCGGTTAAGGATTGTAG
GCTAATGATTCCTGGCTAGTCCATTTTTAT|GTCGCCGAAGCTCCAGTCGGAGATGACAGG
TCGATAGTTCTACGGGGGAGACTAGCTAAT|TTAATCCGCGTCCTCACTCAGTGCGTCGCC
GTCAACCGGCTCTTTACATCGTGATACACA|TACGGGGGAGACTAGCTAATGATTCCTGGC
ATCGTGATACACATTAGCCGGCTCTTTACA|GCAGGCGCCGTGGCCCACTTCAGACCGGCT
ATATGTCTCTTAATCCGCGTCCTCACTCAG|CTTATCTTGGAGGTCTCACTGGCGGCACGC
TCGTGATACACATTAGCCGGCTCTTTACAT|CAGGCGCCGTGGCCCACTTCAGACCGGCTC
TAATGTCGGTATGTCAGCATCTTACGGTAT|CATCGTGATACACATTAGCGAGCAACCGGC
AGCATCGTGATACACATTAGCGAGCAACCG|TTTAGAGAGGCTTCAGAGTGCTGAGGGCTA
TTACCTCAGTACCGGCTCTTTACATCGTGA|ATCTCCCGCCCCACGCTAATGACGATGCGC
ATCGTGATACACATTAGCGAGCAACCGGCT|AGAGAGGCTTCAGAGTGCTGAGGGCTATAT
GACCTCACCGGCTCTTTACATCGTGATACA|TCTTTACATCGTGATACACATTAGGATCGG
CTTTACATCGTGATACACATTAGTTAGTGC|GGATTGTAGACGTCGAGATTTCCCTCCTGC
CTATAAGACTTTTCAGTCTCGTCCCGACTG|TGATACACAACCGGCTCTTTACATCGTGAT
GATACACATTAGCCGGCTCTTTACATCGTG|CGCCGTGGCCCACTTCAGACCGGCTCTTTA
CTCACCGGCTCTTTACATCGTGATACACAA|TTACATCGTGATACACATTAGGATCGGCTC
AGACCGGCTCTTTACATCGTGATACACATT|CATGATGAGACAGTTCGTGCAGTGCAGATG
CCTCACCGGCTCTTTACATCGTGATACACA|TTTACATCGTGATACACATTAGGATCGGCT
TCTTCCGGACGGGCAGTTTAACGCTATAAG|GACCTCACCGGCTCTTTACATCGTGATACA
CCGATCGGCGCATTTTGGGAATATTTCATG|TTAACCGGCTCTTTACATCGTGATACACAT
AGCTCCAACCGGCTCTTTACATCGTGATAC|CGGCTCTTTACATCGTGATACACATTAGGT
GTCAGCATCTTACGGTATCAACTAGTGTCT|CATTAGCGAGCAACCGGCTCTTTACATCGT
TCTCTTAGAGCGCTTTCAGTGCCACTAGTC|TTTTACCGGGGTTCCTGGGGTTACAGCTCA
CCGTCGCGGCGATAGACCGGCTCTTTACAT|CAACTAGTGTCTTCATGATGAGACAGTTCG
TTAGCATGCACCGGGTACGACCGGCTCTTT|ATACACATTAGACCGGTGACCATACAGGAG
GTTTAACGCTATAAGACTTTTCAGTCTCGT|TTACATCGTGATACACAACCGGCTCTTTAC
GCAGTTTAACGCTATAAGACTTTTCAGTCT|TCTTTACATCGTGATACACAACCGGCTCTT
CATTAGGTGCGAGAGATCGATTATTATCAG|TGAGCCGACTCGCTCATATCCGATCGGCGC
TCGTGATACACATTAGTTAGTGCCCTGATC|AGACGTCGAGATTTCCCTCCTGCATGTATC
AAGGATTGTAGACGTCGAGATTTCCCTCCT|CCTGCTGTGCGCCGACCGTGGGCATGCTAT
TGATACACATTAGCATCGTGATACACATTA|ATACACATTAGTTTAGAGAGGCTTCAGAGT
ATTGTAGACGTCGAGATTTCCCTCCTGCAT|CTGTGCGCCGACCGTGGGCATGCTATATGT
ACTCAGTGCGTCGCCGAAGCTCCAGTCGGA|GCACGCATGTGAAAAAGACTTGGGAACGTC
CCTTCACCTACTTACCCTCCGCATCTCCCG|CTAATCGTTCCAGGCAATCAGGCGACTAGT
TAATGATTCCTGGCTAGTCCATTTTTATTG|CGCCGAAGCTCCAGTCGGAGATGACAGGAA
TCGTGATACACATTAGGACTGTACCGGCTC|ATGATTCCTGGCTAGTCCATTTTTATTGCG
TCGCGGCGATAGACCGGCTCTTTACATCGT|CTAGTGTCTTCATGATGAGACAGTTCGTGC
ACATCGTGATACACATTAGCATCGTGATAC|ATCGTGATACACATTAGTTTAGAGAGGCTT
TCCTGCATGTATCGATAGTTCTACGGGGGA|CTATATGTCTCTTAATCCGCGTCCTCACTC
CGGCTCTTTACATCGTGATACACATTAGCC|TATATTTAGACGCAGGCGCCGTGGCCCACT
CATCGTGATACACATTAGGATCCCTCAGTT|CGATGCGCTGTGGGTTTTGAGCTCCAACCG
TAGACCGGTGACCATACAGGAGAGGGGGGA|GCAACCGGCTCTTTACATCGTGATACACAT
GAGAGCAGGTCAACCGGCTCTTTACATCGT|GATAGTTCTACGGGGGAGACTAGCTAATGA
TTTCAGTGCCACTAGTCCTGCTGTGCGCCG|CCTGGGGTTACAGCTCATGGAGCGTGGCCA
CATGTATCGATAGTTCTACGGGGGAGACTA|TGTCTCTTAATCCGCGTCCTCACTCAGTGC
TTTACATCGTGATACACAACCGGCTCTTTA|TACACATTAGGATCGGCTCGGTTAAGGATT
GTCTTCCGGACGGGCAGTTTAACGCTATAA|TGACCTCACCGGCTCTTTACATCGTGATAC
TGGGAATATTTCATGCGTTAATGTCGGTAT|CATCGTGATACACATTAGCATCGTGATACA
CTTTACATCGTGATACACATTAGGTATGAG|ACAGTTCGTGCAGTGCAGATGTCACTTCCC
GCATGTATCGATAGTTCTACGGGGGAGACT|ATGTCTCTTAATCCGCGTCCTCACTCAGTG
GTGCCACTAGTCCTGCTGTGCGCCGACCGT|GGTTACAGCTCATGGAGCGTGGCCACTTGC
TCCGTCGCGGCGATAGACCGGCTCTTTACA|TCAACTAGTGTCTTCATGATGAGACAGTTC
ACATCGTGATACACAACCGGCTCTTTACAT|ACATTAGGATCGGCTCGGTTAAGGATTGTA
GTATGAGCCGACTCGCTCATATCCGATCGG|ACTTCCCGTGGCGACCGGCTCTTTAACCGG
CACATTAGCATGCACCGGGTACGACCGGCT|CGTGATACACATTAGACCGGTGACCATACA
AGCAGGTCAACCGGCTCTTTACATCGTGAT|AGTTCTACGGGGGAGACTAGCTAATGATTC
ACTCGCTCATATCCGATCGGCGCATTTTGG|GCGACCGGCTCTTTAACCGGCTCTTTACAT
TCTTTACATCGTGATACACAACCGGCTCTT|GATACACATTAGGATCGGCTCGGTTAAGGA
TACACATTAGCATGCACCGGGTACGACCGG|ATCGTGATACACATTAGACCGGTGACCATA
CATCGTGATACACATTAGTTAGTGCCCTGA|GTAGACGTCGAGATTTCCCTCCTGCATGTA
TTAGCATCGTGATACACATTAGCGAGCAAC|AGTTTAGAGAGGCTTCAGAGTGCTGAGGGC
ACTTCAGACCGGCTCTTTACATCGTGATAC|ATAAGACTTTTCAGTCTCGTCCCGACTGCG
ACGAGGATCTTCCACAGACACGTCTTCCGG|AATTGAGCGAGTGGCGGTAGGTGACCTCAC
TCCAACCGGCTCTTTACATCGTGATACACA|CTCTTTACATCGTGATACACATTAGGTATG
CATCGTGATACACATTAGTTTAGAGAGGCT|GGGGGGAGCTGCTTTCATGCGGTTCAACGA
TCAGAGTGCTGAGGGCTATATTTAGACGCA|GGATCTTCCACAGACACGTCTTCCGGACGG
TACCCTCCGCATCTCCCGCCCCACGCTAAT|GGCAATCAGGCGACTAGTAGCTTTATAGAG
ATAGAGGTTTCCGTCGCGGCGATAGACCGG|CTTACGGTATCAACTAGTGTCTTCATGATG
TCCGATCGGCGCATTTTGGGAATATTTCAT|TTTAACCGGCTCTTTACATCGTGATACACA
TTCCGGACGGGCAGTTTAACGCTATAAGAC|CCTCACCGGCTCTTTACATCGTGATACACA
AGGTATGAGCCGACTCGCTCATATCCGATC|TCACTTCCCGTGGCGACCGGCTCTTTAACC
TGCTGTGCGCCGACCGTGGGCATGCTATAT|GGAGCGTGGCCACTTGCTTGCCGAGACTTA
GATACACATTAGCACCGGCTCCCACCGCAA|GCAGGTCAACCGGCTCTTTACATCGTGATA
ACCGGCTCTTTACATCGTGATACACATTAG|CCATACAGGAGAGGGGGGAGCTGCTTTCAT
ACGCTATAAGACTTTTCAGTCTCGTCCCGA|TCGTGATACACAACCGGCTCTTTACATCGT
CGGCTCTTTACATCGTGATACACATTAGGA|GGAGACTAGCTAATGATTCCTGGCTAGTCC
CTAGTCCATTTTTATTGCGTGTTTGTCTCT|GTCGGAGATGACAGGAACGGTTCAGTTTTA
CATTTTTATTGCGTGTTTGTCTCTTAGAGC|GATGACAGGAACGGTTCAGTTTTACCGGGG
TGATACACATTAGCATGCACCGGGTACGAC|TACATCGTGATACACATTAGACCGGTGACC
TACGGTATCAACTAGTGTCTTCATGATGAG|CAACCGGCTCTTTACATCGTGATACACATT
TATATTTAGACGCAGGCGCCGTGGCCCACT|CGTCTTCCGGACGGGCAGTTTAACGCTATA
ACTTCACCTCCAGCATATACCTTCACCTAC|CGATTATTATCAGGCGTCGCTAATCGTTCC
GCTCTTTACATCGTGATACACATTAGGGTG|TACATCGTGATACACATTAGGTGCGAGAGA
CGTGATACACATTAGGTGCGAGAGATCGAT|CATTAGGTATGAGCCGACTCGCTCATATCC
TCCCGCCCCACGCTAATGACGATGCGCTGT|CTAGTAGCTTTATAGAGGTTTCCGTCGCGG
CGTGATACACATTAGCCGGCTCTTTACATC|AGGCGCCGTGGCCCACTTCAGACCGGCTCT
CCCCACGCTAATGACGATGCGCTGTGGGTT|AGCTTTATAGAGGTTTCCGTCGCGGCGATA
ATGTCGGTATGTCAGCATCTTACGGTATCA|TCGTGATACACATTAGCGAGCAACCGGCTC
CTCTTTACATCGTGATACACATTAGTTAGT|AAGGATTGTAGACGTCGAGATTTCCCTCCT
GATCTTCCACAGACACGTCTTCCGGACGGG|AGCGAGTGGCGGTAGGTGACCTCACCGGCT
CGAGAGCAGGTCAACCGGCTCTTTACATCG|CGATAGTTCTACGGGGGAGACTAGCTAATG
CCGACTGCGATATGCAACCGGCTCTTTACA|TCGTGATACACATTAGTTAGTGCCCTGATC
ATGATGAGACAGTTCGTGCAGTGCAGATGT|TACACATTAGCCGGCTCTTTACATCGTGAT
GATACACATTAGTTAGTGCCCTGATCGAGA|GTCGAGATTTCCCTCCTGCATGTATCGATA
CTCTTTACATCGTGATACACATTAGGTGCG|TCGTGATACACATTAGGTATGAGCCGACTC
TCTTTACATCGTGATACACATTAGGATCCC|TAATGACGATGCGCTGTGGGTTTTGAGCTC
CACATTAGGATCGGCTCGGTTAAGGATTGT|AGCGCTTTCAGTGCCACTAGTCCTGCTGTG
AGACGTCGAGATTTCCCTCCTGCATGTATC|CGCCGACCGTGGGCATGCTATATGTCTCTT
CTGTGCGCCGACCGTGGGCATGCTATATGT|AGCGTGGCCACTTGCTTGCCGAGACTTATC
TGTACTTCACCTCCAGCATATACCTTCACC|GATCGATTATTATCAGGCGTCGCTAATCGT
ATATTTCATGCGTTAATGTCGGTATGTCAG|TGATACACATTAGCATCGTGATACACATTA
GTTTCCGTCGCGGCGATAGACCGGCTCTTT|GTATCAACTAGTGTCTTCATGATGAGACAG
CGGCTCCCACCGCAATTGAGCGAGTGGCGG|CTTTACATCGTGATACACATTAGGACTGTA
CATTTTGGGAATATTTCATGCGTTAATGTC|CTTTACATCGTGATACACATTAGCATCGTG
ACACATTAGGGTGTACTTCACCTCCAGCAT|TAGGTGCGAGAGATCGATTATTATCAGGCG
GGCGTCGCTAATCGTTCCAGGCAATCAGGC|CATTTTGGGAATATTTCATGCGTTAATGTC
TTAGACCGGTGACCATACAGGAGAGGGGGG|TGCAACCGGCTCTTTACATCGTGATACACA
TTTACATCGTGATACACATTAGGTGCGAGA|TGATACACATTAGGTATGAGCCGACTCGCT
GGGAGCTGCTTTCATGCGGTTCAACGAGGA|ACATTAGCACCGGCTCCCACCGCAATTGAG
GACCATACAGGAGAGGGGGGAGCTGCTTTC|TCTTTACATCGTGATACACATTAGCACCGG
AATCGTTCCAGGCAATCAGGCGACTAGTAG|AATATTTCATGCGTTAATGTCGGTATGTCA
GATACACATTAGGATCGGCTCGGTTAAGGA|TTAGAGCGCTTTCAGTGCCACTAGTCCTGC
GGCTCTTTACATCGTGATACACATTAGGGT|TTACATCGTGATACACATTAGGTGCGAGAG
GTTAAGGATTGTAGACGTCGAGATTTCCCT|AGTCCTGCTGTGCGCCGACCGTGGGCATGC
GGGCATGCTATATGTCTCTTAATCCGCGTC|TTGCCGAGACTTATCTTGGAGGTCTCACTG
GGGCAGTTTAACGCTATAAGACTTTTCAGT|GCTCTTTACATCGTGATACACAACCGGCTC
AGGGCTATATTTAGACGCAGGCGCCGTGGC|AGACACGTCTTCCGGACGGGCAGTTTAACG
GATTCCTGGCTAGTCCATTTTTATTGCGTG|GAAGCTCCAGTCGGAGATGACAGGAACGGT
GGCGCCGTGGCCCACTTCAGACCGGCTCTT|GCAGTTTAACGCTATAAGACTTTTCAGTCT
ATTGAGCGAGTGGCGGTAGGTGACCTCACC|ACACATTAGGACTGTACCGGCTCTTTACAT
TTATACCGGCTCTTTACATCGTGATACACA|CGGCTCTTTACATCGTGATACACATTAGGT
CTCTTTACATCGTGATACACATTAGCCGGC|ATTTAGACGCAGGCGCCGTGGCCCACTTCA
CACCGCAATTGAGCGAGTGGCGGTAGGTGA|TCGTGATACACATTAGGACTGTACCGGCTC
TCTTTAACCGGCTCTTTACATCGTGATACA|TACGACCGGCTCTTTACATCGTGATACACA
CCTCAGTTATACCGGCTCTTTACATCGTGA|TCCAACCGGCTCTTTACATCGTGATACACA
AATGATTCCTGGCTAGTCCATTTTTATTGC|GCCGAAGCTCCAGTCGGAGATGACAGGAAC
AGCTTACCTCAGTACCGGCTCTTTACATCG|CGCATCTCCCGCCCCACGCTAATGACGATG
AGGATCGGCTCGGTTAAGGATTGTAGACGT|TTCAGTGCCACTAGTCCTGCTGTGCGCCGA
GAGTGGCGGTAGGTGACCTCACCGGCTCTT|AGGACTGTACCGGCTCTTTACATCGTGATA
ACACGTCTTCCGGACGGGCAGTTTAACGCT|TAGGTGACCTCACCGGCTCTTTACATCGTG
TGGGCATGCTATATGTCTCTTAATCCGCGT|CTTGCCGAGACTTATCTTGGAGGTCTCACT
CGATGCGCTGTGGGTTTTGAGCTCCAACCG|TTCCGTCGCGGCGATAGACCGGCTCTTTAC
TTCCAGGCAATCAGGCGACTAGTAGCTTTA|TTCATGCGTTAATGTCGGTATGTCAGCATC
ACATTAGGATCGGCTCGGTTAAGGATTGTA|GCGCTTTCAGTGCCACTAGTCCTGCTGTGC
GTACCGGCTCTTTACATCGTGATACACATT|CCCCACGCTAATGACGATGCGCTGTGGGTT
AGGATCTTCCACAGACACGTCTTCCGGACG|TGAGCGAGTGGCGGTAGGTGACCTCACCGG
TGTAGACGTCGAGATTTCCCTCCTGCATGT|GTGCGCCGACCGTGGGCATGCTATATGTCT
GCAGTGCAGATGTCACTTCCCGTGGCGACC|TTTACATCGTGATACACATTAGCATGCACC
CCTCCTGCATGTATCGATAGTTCTACGGGG|TGCTATATGTCTCTTAATCCGCGTCCTCAC
ATAGTTCTACGGGGGAGACTAGCTAATGAT|ATCCGCGTCCTCACTCAGTGCGTCGCCGAA
TGATACACATTAGTTAGTGCCCTGATCGAG|CGTCGAGATTTCCCTCCTGCATGTATCGAT
GGTTTCCGTCGCGGCGATAGACCGGCTCTT|GGTATCAACTAGTGTCTTCATGATGAGACA
GCTGCTTTCATGCGGTTCAACGAGGATCTT|TAGCACCGGCTCCCACCGCAATTGAGCGAG
GATACACATTAGGGTGTACTTCACCTCCAG|CATTAGGTGCGAGAGATCGATTATTATCAG
TCGTCCCGACTGCGATATGCAACCGGCTCT|TTACATCGTGATACACATTAGTTAGTGCCC
CATCGTGATACACATTAGACCGGTGACCAT|TCCCGACTGCGATATGCAACCGGCTCTTTA
ATTGCGTGTTTGTCTCTTAGAGCGCTTTCA|GGAACGGTTCAGTTTTACCGGGGTTCCTGG
TGCATGTATCGATAGTTCTACGGGGGAGAC|TATGTCTCTTAATCCGCGTCCTCACTCAGT
CGACTCGCTCATATCCGATCGGCGCATTTT|TGGCGACCGGCTCTTTAACCGGCTCTTTAC
GGGGAGACTAGCTAATGATTCCTGGCTAGT|CACTCAGTGCGTCGCCGAAGCTCCAGTCGG
ACTGCGATATGCAACCGGCTCTTTACATCG|TGATACACATTAGTTAGTGCCCTGATCGAG
CACTTCAGACCGGCTCTTTACATCGTGATA|TATAAGACTTTTCAGTCTCGTCCCGACTGC
TTAGGTGCGAGAGATCGATTATTATCAGGC|AGCCGACTCGCTCATATCCGATCGGCGCAT
ACATTAGGATCCCTCAGTTATACCGGCTCT|GGGTTTTGAGCTCCAACCGGCTCTTTACAT
GTACTTCACCTCCAGCATATACCTTCACCT|ATCGATTATTATCAGGCGTCGCTAATCGTT
CCGGCTCTTTACATCGTGATACACATTAGG|CACGCTAATGACGATGCGCTGTGGGTTTTG
GGGCTATATTTAGACGCAGGCGCCGTGGCC|GACACGTCTTCCGGACGGGCAGTTTAACGC
ACCGGCTCTTTACATCGTGATACACATTAG|GCTATATTTAGACGCAGGCGCCGTGGCCCA
TCGTGATACACATTAGCATCGTGATACACA|GTGATACACATTAGTTTAGAGAGGCTTCAG
GTCACTTCCCGTGGCGACCGGCTCTTTAAC|ATACACATTAGCATGCACCGGGTACGACCG
TCCTGGCTAGTCCATTTTTATTGCGTGTTT|GCTCCAGTCGGAGATGACAGGAACGGTTCA
GTGATACACATTAGCCGGCTCTTTACATCG|GGCGCCGTGGCCCACTTCAGACCGGCTCTT
CATATACCTTCACCTACTTACCCTCCGCAT|GCGTCGCTAATCGTTCCAGGCAATCAGGCG
CGGCGCATTTTGGGAATATTTCATGCGTTA|CGGCTCTTTACATCGTGATACACATTAGCA
ATTAGGATCGGCTCGGTTAAGGATTGTAGA|GCTTTCAGTGCCACTAGTCCTGCTGTGCGC
TCTTTACATCGTGATACACATTAGGTATGA|GACAGTTCGTGCAGTGCAGATGTCACTTCC
TTTACATCGTGATACACATTAGGGTGTACT|TCGTGATACACATTAGGTGCGAGAGATCGA
GTCCTGCTGTGCGCCGACCGTGGGCATGCT|TCATGGAGCGTGGCCACTTGCTTGCCGAGA
ACTGTACCGGCTCTTTACATCGTGATACAC|CATTTTTATTGCGTGTTTGTCTCTTAGAGC
CTCACTCAGTGCGTCGCCGAAGCTCCAGTC|GCGGCACGCATGTGAAAAAGACTTGGGAAC
ACATCGTGATACACATTAGGTGCGAGAGAT|TACACATTAGGTATGAGCCGACTCGCTCAT
AGCATATACCTTCACCTACTTACCCTCCGC|AGGCGTCGCTAATCGTTCCAGGCAATCAGG
CCGGACGGGCAGTTTAACGCTATAAGACTT|TCACCGGCTCTTTACATCGTGATACACAAC
CGTGATACACATTAGCACCGGCTCCCACCG|AGAGCAGGTCAACCGGCTCTTTACATCGTG
GGACTGTACCGGCTCTTTACATCGTGATAC|TCCATTTTTATTGCGTGTTTGTCTCTTAGA
CTACGGGGGAGACTAGCTAATGATTCCTGG|GTCCTCACTCAGTGCGTCGCCGAAGCTCCA
GGCTCTTTACATCGTGATACACATTAGTTT|TACAGGAGAGGGGGGAGCTGCTTTCATGCG
GCTCATATCCGATCGGCGCATTTTGGGAAT|CCGGCTCTTTAACCGGCTCTTTACATCGTG
TTAATGTCGGTATGTCAGCATCTTACGGTA|GCATCGTGATACACATTAGCGAGCAACCGG
ATATCCGATCGGCGCATTTTGGGAATATTT|CTCTTTAACCGGCTCTTTACATCGTGATAC
GCCCCACGCTAATGACGATGCGCTGTGGGT|TAGCTTTATAGAGGTTTCCGTCGCGGCGAT
CGTCCTCACTCAGTGCGTCGCCGAAGCTCC|ACTGGCGGCACGCATGTGAAAAAGACTTGG
TCGAGAGCAGGTCAACCGGCTCTTTACATC|TCGATAGTTCTACGGGGGAGACTAGCTAAT
GAGGCTTCAGAGTGCTGAGGGCTATATTTA|CAACGAGGATCTTCCACAGACACGTCTTCC
CTTTACATCGTGATACACATTAGGTGCGAG|GTGATACACATTAGGTATGAGCCGACTCGC
ATGCGGTTCAACGAGGATCTTCCACAGACA|CTCCCACCGCAATTGAGCGAGTGGCGGTAG
ATACACATTAGGACTGTACCGGCTCTTTAC|TCCTGGCTAGTCCATTTTTATTGCGTGTTT
GATTTCCCTCCTGCATGTATCGATAGTTCT|TGGGCATGCTATATGTCTCTTAATCCGCGT
CGTTCCAGGCAATCAGGCGACTAGTAGCTT|ATTTCATGCGTTAATGTCGGTATGTCAGCA
GATTATTATCAGGCGTCGCTAATCGTTCCA|TCCGATCGGCGCATTTTGGGAATATTTCAT
TGCTATATGTCTCTTAATCCGCGTCCTCAC|GAGACTTATCTTGGAGGTCTCACTGGCGGC
ACGCAGGCGCCGTGGCCCACTTCAGACCGG|GACGGGCAGTTTAACGCTATAAGACTTTTC
CTCGTCCCGACTGCGATATGCAACCGGCTC|TTTACATCGTGATACACATTAGTTAGTGCC
GCCCACTTCAGACCGGCTCTTTACATCGTG|CGCTATAAGACTTTTCAGTCTCGTCCCGAC
TGATACACATTAGGGTGTACTTCACCTCCA|ACATTAGGTGCGAGAGATCGATTATTATCA
GTCGCGGCGATAGACCGGCTCTTTACATCG|ACTAGTGTCTTCATGATGAGACAGTTCGTG
GACTGCGATATGCAACCGGCTCTTTACATC|GTGATACACATTAGTTAGTGCCCTGATCGA
CTTCACCTACTTACCCTCCGCATCTCCCGC|TAATCGTTCCAGGCAATCAGGCGACTAGTA
CGAGAGATCGATTATTATCAGGCGTCGCTA|TCGCTCATATCCGATCGGCGCATTTTGGGA
AGTCCTGCTGTGCGCCGACCGTGGGCATGC|CTCATGGAGCGTGGCCACTTGCTTGCCGAG
GTTTGTCTCTTAGAGCGCTTTCAGTGCCAC|TTCAGTTTTACCGGGGTTCCTGGGGTTACA
CGTGGCGACCGGCTCTTTAACCGGCTCTTT|AGCATGCACCGGGTACGACCGGCTCTTTAC
CTCGCTCATATCCGATCGGCGCATTTTGGG|CGACCGGCTCTTTAACCGGCTCTTTACATC
GCGATATGCAACCGGCTCTTTACATCGTGA|TACACATTAGTTAGTGCCCTGATCGAGAGC
GGCTCTTTACATCGTGATACACATTAGCAC|GTGCCCTGATCGAGAGCAGGTCAACCGGCT
AATCCGCGTCCTCACTCAGTGCGTCGCCGA|GGTCTCACTGGCGGCACGCATGTGAAAAAG
GCGAGTGGCGGTAGGTGACCTCACCGGCTC|TTAGGACTGTACCGGCTCTTTACATCGTGA
GGCTCTTTACATCGTGATACACATTAGGTG|CATCGTGATACACATTAGGTATGAGCCGAC
GAGATTTCCCTCCTGCATGTATCGATAGTT|CGTGGGCATGCTATATGTCTCTTAATCCGC
GCTCTTTACATCGTGATACACATTAGCACC|TGCCCTGATCGAGAGCAGGTCAACCGGCTC
TGCAGTGCAGATGTCACTTCCCGTGGCGAC|CTTTACATCGTGATACACATTAGCATGCAC
TACATCGTGATACACATTAGGTGCGAGAGA|ATACACATTAGGTATGAGCCGACTCGCTCA
CCATACAGGAGAGGGGGGAGCTGCTTTCAT|TTTACATCGTGATACACATTAGCACCGGCT
GTCTCTTAGAGCGCTTTCAGTGCCACTAGT|GTTTTACCGGGGTTCCTGGGGTTACAGCTC
CTTCAGACCGGCTCTTTACATCGTGATACA|TAAGACTTTTCAGTCTCGTCCCGACTGCGA
GCACCGGCTCCCACCGCAATTGAGCGAGTG|GGCTCTTTACATCGTGATACACATTAGGAC
TCTTAGAGCGCTTTCAGTGCCACTAGTCCT|TTACCGGGGTTCCTGGGGTTACAGCTCATG
AGAGGTTTCCGTCGCGGCGATAGACCGGCT|TACGGTATCAACTAGTGTCTTCATGATGAG
GCTCTTTACATCGTGATACACATTAGGATC|GCTAATGACGATGCGCTGTGGGTTTTGAGC
CTTTACATCGTGATACACATTAGACCGGTG|TCTCGTCCCGACTGCGATATGCAACCGGCT
TCGTGATACACAACCGGCTCTTTACATCGT|TTAGGATCGGCTCGGTTAAGGATTGTAGAC
GCTCCCACCGCAATTGAGCGAGTGGCGGTA|TTACATCGTGATACACATTAGGACTGTACC
AGGCGACTAGTAGCTTTATAGAGGTTTCCG|TGTCGGTATGTCAGCATCTTACGGTATCAA
ATTAGGTATGAGCCGACTCGCTCATATCCG|ATGTCACTTCCCGTGGCGACCGGCTCTTTA
GCGAGCAACCGGCTCTTTACATCGTGATAC|GCTGAGGGCTATATTTAGACGCAGGCGCCG
GCGCATTTTGGGAATATTTCATGCGTTAAT|GCTCTTTACATCGTGATACACATTAGCATC
GTTTAGAGAGGCTTCAGAGTGCTGAGGGCT|TGCGGTTCAACGAGGATCTTCCACAGACAC
CATTAGGACTGTACCGGCTCTTTACATCGT|GCTAGTCCATTTTTATTGCGTGTTTGTCTC
GGCAGTTTAACGCTATAAGACTTTTCAGTC|CTCTTTACATCGTGATACACAACCGGCTCT
TCACTCAGTGCGTCGCCGAAGCTCCAGTCG|CGGCACGCATGTGAAAAAGACTTGGGAACG
GTGCAGATGTCACTTCCCGTGGCGACCGGC|ACATCGTGATACACATTAGCATGCACCGGG
ATTATCAGGCGTCGCTAATCGTTCCAGGCA|ATCGGCGCATTTTGGGAATATTTCATGCGT
GCTCTTTACATCGTGATACACATTAGACCG|CAGTCTCGTCCCGACTGCGATATGCAACCG
AGTGTCTTCATGATGAGACAGTTCGTGCAG|ACATCGTGATACACATTAGCCGGCTCTTTA
GTGGCGACCGGCTCTTTAACCGGCTCTTTA|GCATGCACCGGGTACGACCGGCTCTTTACA
CTATATTTAGACGCAGGCGCCGTGGCCCAC|ACGTCTTCCGGACGGGCAGTTTAACGCTAT
CAGTGCAGATGTCACTTCCCGTGGCGACCG|TTACATCGTGATACACATTAGCATGCACCG
TAGCGAGCAACCGGCTCTTTACATCGTGAT|GTGCTGAGGGCTATATTTAGACGCAGGCGC
GTGCGCCGACCGTGGGCATGCTATATGTCT|CGTGGCCACTTGCTTGCCGAGACTTATCTT
CCCACCGCAATTGAGCGAGTGGCGGTAGGT|CATCGTGATACACATTAGGACTGTACCGGC
ACATCGTGATACACATTAGGACTGTACCGG|CTAATGATTCCTGGCTAGTCCATTTTTATT
CCGGCTCTTTACATCGTGATACACATTAGA|TTTCAGTCTCGTCCCGACTGCGATATGCAA
GATACACATTAGGACTGTACCGGCTCTTTA|TTCCTGGCTAGTCCATTTTTATTGCGTGTT
ATTTTTATTGCGTGTTTGTCTCTTAGAGCG|ATGACAGGAACGGTTCAGTTTTACCGGGGT
ATTAGCATCGTGATACACATTAGCGAGCAA|TAGTTTAGAGAGGCTTCAGAGTGCTGAGGG
CGACTAGTAGCTTTATAGAGGTTTCCGTCG|CGGTATGTCAGCATCTTACGGTATCAACTA
ACCGGCTCTTTACATCGTGATACACATTAG|CCACGCTAATGACGATGCGCTGTGGGTTTT
AGTTATACCGGCTCTTTACATCGTGATACA|ACCGGCTCTTTACATCGTGATACACATTAG
GATTGTAGACGTCGAGATTTCCCTCCTGCA|GCTGTGCGCCGACCGTGGGCATGCTATATG
TAGAGCGCTTTCAGTGCCACTAGTCCTGCT|CCGGGGTTCCTGGGGTTACAGCTCATGGAG
TTTCCGTCGCGGCGATAGACCGGCTCTTTA|TATCAACTAGTGTCTTCATGATGAGACAGT
CATGCGGTTCAACGAGGATCTTCCACAGAC|GCTCCCACCGCAATTGAGCGAGTGGCGGTA
ACGTCGAGATTTCCCTCCTGCATGTATCGA|CCGACCGTGGGCATGCTATATGTCTCTTAA
CATTAGCACCGGCTCCCACCGCAATTGAGC|CAACCGGCTCTTTACATCGTGATACACATT
GCATGCTATATGTCTCTTAATCCGCGTCCT|GCCGAGACTTATCTTGGAGGTCTCACTGGC
TCGTGCAGTGCAGATGTCACTTCCCGTGGC|GCTCTTTACATCGTGATACACATTAGCATG
TTTCATGCGTTAATGTCGGTATGTCAGCAT|TACACATTAGCATCGTGATACACATTAGCG
ATACACATTAGGATCCCTCAGTTATACCGG|CTGTGGGTTTTGAGCTCCAACCGGCTCTTT
GTAGACGTCGAGATTTCCCTCCTGCATGTA|TGCGCCGACCGTGGGCATGCTATATGTCTC
TTTTGAGCTCCAACCGGCTCTTTACATCGT|TAGACCGGCTCTTTACATCGTGATACACAT
TCTTTACATCGTGATACACATTAGCCGGCT|TTTAGACGCAGGCGCCGTGGCCCACTTCAG
GGCTCGGTTAAGGATTGTAGACGTCGAGAT|GCCACTAGTCCTGCTGTGCGCCGACCGTGG
CGGTAGGTGACCTCACCGGCTCTTTACATC|GTACCGGCTCTTTACATCGTGATACACATT
AGTTTAGAGAGGCTTCAGAGTGCTGAGGGC|ATGCGGTTCAACGAGGATCTTCCACAGACA
TGCGGTTCAACGAGGATCTTCCACAGACAC|TCCCACCGCAATTGAGCGAGTGGCGGTAGG
CTACTTACCCTCCGCATCTCCCGCCCCACG|TTCCAGGCAATCAGGCGACTAGTAGCTTTA
GGCGGTAGGTGACCTCACCGGCTCTTTACA|CTGTACCGGCTCTTTACATCGTGATACACA
CACCTCCAGCATATACCTTCACCTACTTAC|TATTATCAGGCGTCGCTAATCGTTCCAGGC
GCATCGTGATACACATTAGCGAGCAACCGG|TTAGAGAGGCTTCAGAGTGCTGAGGGCTAT
GTGTACTTCACCTCCAGCATATACCTTCAC|AGATCGATTATTATCAGGCGTCGCTAATCG
ACATCGTGATACACATTAGACCGGTGACCA|GTCCCGACTGCGATATGCAACCGGCTCTTT
TTAGACGCAGGCGCCGTGGCCCACTTCAGA|TCCGGACGGGCAGTTTAACGCTATAAGACT
AGAGGCTTCAGAGTGCTGAGGGCTATATTT|TCAACGAGGATCTTCCACAGACACGTCTTC
GTGATACACATTAGGTATGAGCCGACTCGC|GCAGTGCAGATGTCACTTCCCGTGGCGACC
GATGTCACTTCCCGTGGCGACCGGCTCTTT|GTGATACACATTAGCATGCACCGGGTACGA
AATATTTCATGCGTTAATGTCGGTATGTCA|GTGATACACATTAGCATCGTGATACACATT
CAATCAGGCGACTAGTAGCTTTATAGAGGT|GTTAATGTCGGTATGTCAGCATCTTACGGT
CATCGTGATACACATTAGCGAGCAACCGGC|TAGAGAGGCTTCAGAGTGCTGAGGGCTATA
ATGTCACTTCCCGTGGCGACCGGCTCTTTA|TGATACACATTAGCATGCACCGGGTACGAC
GCTCTTTACATCGTGATACACATTAGCATC|TCTTTACATCGTGATACACATTAGTTTAGA
CAGTACCGGCTCTTTACATCGTGATACACA|CGCCCCACGCTAATGACGATGCGCTGTGGG
ACATTAGCCGGCTCTTTACATCGTGATACA|TGGCCCACTTCAGACCGGCTCTTTACATCG
AGTGCCACTAGTCCTGCTGTGCGCCGACCG|GGGTTACAGCTCATGGAGCGTGGCCACTTG
ATTAGCACCGGCTCCCACCGCAATTGAGCG|AACCGGCTCTTTACATCGTGATACACATTA
AGGCGCCGTGGCCCACTTCAGACCGGCTCT|GGCAGTTTAACGCTATAAGACTTTTCAGTC
TACACATTAGCATCGTGATACACATTAGCG|CACATTAGTTTAGAGAGGCTTCAGAGTGCT
TAACCGGCTCTTTACATCGTGATACACATT|ACCGGCTCTTTACATCGTGATACACATTAG
TACATCGTGATACACATTAGCATCGTGATA|CATCGTGATACACATTAGTTTAGAGAGGCT
AGCATCTTACGGTATCAACTAGTGTCTTCA|TAGCGAGCAACCGGCTCTTTACATCGTGAT
TCGGTTAAGGATTGTAGACGTCGAGATTTC|ACTAGTCCTGCTGTGCGCCGACCGTGGGCA
CGACCGGCTCTTTAACCGGCTCTTTACATC|GCACCGGGTACGACCGGCTCTTTACATCGT
TACTTCACCTCCAGCATATACCTTCACCTA|TCGATTATTATCAGGCGTCGCTAATCGTTC
TTGGGAATATTTCATGCGTTAATGTCGGTA|ACATCGTGATACACATTAGCATCGTGATAC
CGTCGCTAATCGTTCCAGGCAATCAGGCGA|TTTTGGGAATATTTCATGCGTTAATGTCGG
ATACACATTAGCATGCACCGGGTACGACCG|CATCGTGATACACATTAGACCGGTGACCAT
ATTTCCCTCCTGCATGTATCGATAGTTCTA|GGGCATGCTATATGTCTCTTAATCCGCGTC
CCCTCCTGCATGTATCGATAGTTCTACGGG|ATGCTATATGTCTCTTAATCCGCGTCCTCA
TTAGCGAGCAACCGGCTCTTTACATCGTGA|AGTGCTGAGGGCTATATTTAGACGCAGGCG
TAGCATGCACCGGGTACGACCGGCTCTTTA|TACACATTAGACCGGTGACCATACAGGAGA
CACTAGTCCTGCTGTGCGCCGACCGTGGGC|ACAGCTCATGGAGCGTGGCCACTTGCTTGC
GTCGGTATGTCAGCATCTTACGGTATCAAC|GTGATACACATTAGCGAGCAACCGGCTCTT
GGTCAACCGGCTCTTTACATCGTGATACAC|CTACGGGGGAGACTAGCTAATGATTCCTGG
ACACATTAGCCGGCTCTTTACATCGTGATA|CGTGGCCCACTTCAGACCGGCTCTTTACAT
CCGGCTCTTTACATCGTGATACACATTAGG|TATTGCGTGTTTGTCTCTTAGAGCGCTTTC
ACCGGCTCTTTACATCGTGATACACATTAG|TTACATCGTGATACACATTAGGTATGAGCC
GGTGTACTTCACCTCCAGCATATACCTTCA|GAGATCGATTATTATCAGGCGTCGCTAATC
ACCCTCCGCATCTCCCGCCCCACGCTAATG|GCAATCAGGCGACTAGTAGCTTTATAGAGG
AGCAACCGGCTCTTTACATCGTGATACACA|GAGGGCTATATTTAGACGCAGGCGCCGTGG
CATATCCGATCGGCGCATTTTGGGAATATT|GCTCTTTAACCGGCTCTTTACATCGTGATA
ACCTACTTACCCTCCGCATCTCCCGCCCCA|CGTTCCAGGCAATCAGGCGACTAGTAGCTT
AGGATCCCTCAGTTATACCGGCTCTTTACA|TTGAGCTCCAACCGGCTCTTTACATCGTGA
TCACTTCCCGTGGCGACCGGCTCTTTAACC|TACACATTAGCATGCACCGGGTACGACCGG
ACAACCGGCTCTTTACATCGTGATACACAT|GCTCGGTTAAGGATTGTAGACGTCGAGATT
TAAGACTTTTCAGTCTCGTCCCGACTGCGA|TACACAACCGGCTCTTTACATCGTGATACA
CACATTAGTTTAGAGAGGCTTCAGAGTGCT|GCTTTCATGCGGTTCAACGAGGATCTTCCA
TTCACCTCCAGCATATACCTTCACCTACTT|ATTATTATCAGGCGTCGCTAATCGTTCCAG
ATTAGCATGCACCGGGTACGACCGGCTCTT|GATACACATTAGACCGGTGACCATACAGGA
TCTTTACATCGTGATACACATTAGCACCGG|CCCTGATCGAGAGCAGGTCAACCGGCTCTT
ATACACATTAGCATCGTGATACACATTAGC|ACACATTAGTTTAGAGAGGCTTCAGAGTGC
TTCAGTGCCACTAGTCCTGCTGTGCGCCGA|CTGGGGTTACAGCTCATGGAGCGTGGCCAC
GTCGAGATTTCCCTCCTGCATGTATCGATA|GACCGTGGGCATGCTATATGTCTCTTAATC
CTTTACATCGTGATACACATTAGCATGCAC|ACCGGCTCTTTACATCGTGATACACATTAG
GCTCGGTTAAGGATTGTAGACGTCGAGATT|CCACTAGTCCTGCTGTGCGCCGACCGTGGG
CACATTAGGGTGTACTTCACCTCCAGCATA|AGGTGCGAGAGATCGATTATTATCAGGCGT
TTACGGTATCAACTAGTGTCTTCATGATGA|GCAACCGGCTCTTTACATCGTGATACACAT
GCTCTTTACATCGTGATACACATTAGGTGC|ATCGTGATACACATTAGGTATGAGCCGACT
TTTAACCGGCTCTTTACATCGTGATACACA|CGACCGGCTCTTTACATCGTGATACACATT
TCAGTGCGTCGCCGAAGCTCCAGTCGGAGA|ACGCATGTGAAAAAGACTTGGGAACGTCTT
ACACAACCGGCTCTTTACATCGTGATACAC|CGGCTCGGTTAAGGATTGTAGACGTCGAGA
CTAATGACGATGCGCTGTGGGTTTTGAGCT|TAGAGGTTTCCGTCGCGGCGATAGACCGGC
TTGTCTCTTAGAGCGCTTTCAGTGCCACTA|CAGTTTTACCGGGGTTCCTGGGGTTACAGC
GTGATACACAACCGGCTCTTTACATCGTGA|AGGATCGGCTCGGTTAAGGATTGTAGACGT
GCTCTTTACATCGTGATACACATTAGCATG|CAGACCGGCTCTTTACATCGTGATACACAT
TCACCTCCAGCATATACCTTCACCTACTTA|TTATTATCAGGCGTCGCTAATCGTTCCAGG
CCACAGACACGTCTTCCGGACGGGCAGTTT|TGGCGGTAGGTGACCTCACCGGCTCTTTAC
GTGGGCATGCTATATGTCTCTTAATCCGCG|GCTTGCCGAGACTTATCTTGGAGGTCTCAC
TTACATCGTGATACACATTAGCATGCACCG|CGGCTCTTTACATCGTGATACACATTAGAC
CGATATGCAACCGGCTCTTTACATCGTGAT|ACACATTAGTTAGTGCCCTGATCGAGAGCA
TAGCTAATGATTCCTGGCTAGTCCATTTTT|GCGTCGCCGAAGCTCCAGTCGGAGATGACA
GTGATACACATTAGGATCGGCTCGGTTAAG|TCTTAGAGCGCTTTCAGTGCCACTAGTCCT
GTTCCAGGCAATCAGGCGACTAGTAGCTTT|TTTCATGCGTTAATGTCGGTATGTCAGCAT
CTCTTTAACCGGCTCTTTACATCGTGATAC|GTACGACCGGCTCTTTACATCGTGATACAC
GTGTTTGTCTCTTAGAGCGCTTTCAGTGCC|GGTTCAGTTTTACCGGGGTTCCTGGGGTTA
CCCGCCCCACGCTAATGACGATGCGCTGTG|TAGTAGCTTTATAGAGGTTTCCGTCGCGGC
CAGAGTGCTGAGGGCTATATTTAGACGCAG|GATCTTCCACAGACACGTCTTCCGGACGGG
ATTAGGACTGTACCGGCTCTTTACATCGTG|CTAGTCCATTTTTATTGCGTGTTTGTCTCT
ATCCGATCGGCGCATTTTGGGAATATTTCA|CTTTAACCGGCTCTTTACATCGTGATACAC
ATCAGGCGTCGCTAATCGTTCCAGGCAATC|GGCGCATTTTGGGAATATTTCATGCGTTAA
AACGCTATAAGACTTTTCAGTCTCGTCCCG|ATCGTGATACACAACCGGCTCTTTACATCG
TTACATCGTGATACACATTAGCCGGCTCTT|AGACGCAGGCGCCGTGGCCCACTTCAGACC
ATCGAGAGCAGGTCAACCGGCTCTTTACAT|ATCGATAGTTCTACGGGGGAGACTAGCTAA
CGGCGATAGACCGGCTCTTTACATCGTGAT|GTGTCTTCATGATGAGACAGTTCGTGCAGT
ATGATTCCTGGCTAGTCCATTTTTATTGCG|CCGAAGCTCCAGTCGGAGATGACAGGAACG
TACCTCAGTACCGGCTCTTTACATCGTGAT|TCTCCCGCCCCACGCTAATGACGATGCGCT
TGTGGGTTTTGAGCTCCAACCGGCTCTTTA|CGGCGATAGACCGGCTCTTTACATCGTGAT
TCCGCGTCCTCACTCAGTGCGTCGCCGAAG|TCTCACTGGCGGCACGCATGTGAAAAAGAC
TCGAGATTTCCCTCCTGCATGTATCGATAG|ACCGTGGGCATGCTATATGTCTCTTAATCC
TAGCTTACCTCAGTACCGGCTCTTTACATC|CCGCATCTCCCGCCCCACGCTAATGACGAT
ATTAGGTGCGAGAGATCGATTATTATCAGG|GAGCCGACTCGCTCATATCCGATCGGCGCA
TGCGATATGCAACCGGCTCTTTACATCGTG|ATACACATTAGTTAGTGCCCTGATCGAGAG
TCCCTCAGTTATACCGGCTCTTTACATCGT|GCTCCAACCGGCTCTTTACATCGTGATACA
CGCTGTGGGTTTTGAGCTCCAACCGGCTCT|TCGCGGCGATAGACCGGCTCTTTACATCGT
GCCGGCTCTTTACATCGTGATACACATTAG|ACTTCAGACCGGCTCTTTACATCGTGATAC
CCGGCTCTTTACATCGTGATACACATTAGT|CATACAGGAGAGGGGGGAGCTGCTTTCATG
TATATGTCTCTTAATCCGCGTCCTCACTCA|ACTTATCTTGGAGGTCTCACTGGCGGCACG
TCCAGCATATACCTTCACCTACTTACCCTC|ATCAGGCGTCGCTAATCGTTCCAGGCAATC
GATCGGCTCGGTTAAGGATTGTAGACGTCG|CAGTGCCACTAGTCCTGCTGTGCGCCGACC
CGCTAATGACGATGCGCTGTGGGTTTTGAG|TATAGAGGTTTCCGTCGCGGCGATAGACCG
CATACAGGAGAGGGGGGAGCTGCTTTCATG|TTACATCGTGATACACATTAGCACCGGCTC
TTCAACGAGGATCTTCCACAGACACGTCTT|CCGCAATTGAGCGAGTGGCGGTAGGTGACC
GTGATACACATTAGCGAGCAACCGGCTCTT|GAGGCTTCAGAGTGCTGAGGGCTATATTTA
CACCTACTTACCCTCCGCATCTCCCGCCCC|TCGTTCCAGGCAATCAGGCGACTAGTAGCT
TTTTCAGTCTCGTCCCGACTGCGATATGCA|ACCGGCTCTTTACATCGTGATACACATTAG
ACCGGCTCTTTACATCGTGATACACATTAG|GGGGAGACTAGCTAATGATTCCTGGCTAGT
TACCGGCTCTTTACATCGTGATACACATTA|CCCACGCTAATGACGATGCGCTGTGGGTTT
GTTATACCGGCTCTTTACATCGTGATACAC|CCGGCTCTTTACATCGTGATACACATTAGG
CGGGCAGTTTAACGCTATAAGACTTTTCAG|GGCTCTTTACATCGTGATACACAACCGGCT
TGTGCGCCGACCGTGGGCATGCTATATGTC|GCGTGGCCACTTGCTTGCCGAGACTTATCT
ATACACATTAGGATCGGCTCGGTTAAGGAT|TAGAGCGCTTTCAGTGCCACTAGTCCTGCT
TTCGTGCAGTGCAGATGTCACTTCCCGTGG|GGCTCTTTACATCGTGATACACATTAGCAT
CAGACACGTCTTCCGGACGGGCAGTTTAAC|CGGTAGGTGACCTCACCGGCTCTTTACATC
CGTCTTCCGGACGGGCAGTTTAACGCTATA|GTGACCTCACCGGCTCTTTACATCGTGATA
CTCTTTACATCGTGATACACATTAGACCGG|AGTCTCGTCCCGACTGCGATATGCAACCGG
CCGCATCTCCCGCCCCACGCTAATGACGAT|CAGGCGACTAGTAGCTTTATAGAGGTTTCC
TCTTTACATCGTGATACACATTAGCATCGT|TTTACATCGTGATACACATTAGTTTAGAGA
ATTAGACCGGTGACCATACAGGAGAGGGGG|ATGCAACCGGCTCTTTACATCGTGATACAC
GCTATATTTAGACGCAGGCGCCGTGGCCCA|CACGTCTTCCGGACGGGCAGTTTAACGCTA
CGGCTCTTTACATCGTGATACACATTAGAC|TTCAGTCTCGTCCCGACTGCGATATGCAAC
TAGACCGGCTCTTTACATCGTGATACACAT|TCATGATGAGACAGTTCGTGCAGTGCAGAT
TCTTTACATCGTGATACACATTAGACCGGT|GTCTCGTCCCGACTGCGATATGCAACCGGC
CGGCTCGGTTAAGGATTGTAGACGTCGAGA|TGCCACTAGTCCTGCTGTGCGCCGACCGTG
TTAGTTTAGAGAGGCTTCAGAGTGCTGAGG|TCATGCGGTTCAACGAGGATCTTCCACAGA
AACCGGCTCTTTACATCGTGATACACATTA|GGGGGAGACTAGCTAATGATTCCTGGCTAG
GTGCTGAGGGCTATATTTAGACGCAGGCGC|TTCCACAGACACGTCTTCCGGACGGGCAGT
TCCGGACGGGCAGTTTAACGCTATAAGACT|CTCACCGGCTCTTTACATCGTGATACACAA
TTCCTGGCTAGTCCATTTTTATTGCGTGTT|AGCTCCAGTCGGAGATGACAGGAACGGTTC
TAGACGCAGGCGCCGTGGCCCACTTCAGAC|CCGGACGGGCAGTTTAACGCTATAAGACTT
TTCATGCGGTTCAACGAGGATCTTCCACAG|CGGCTCCCACCGCAATTGAGCGAGTGGCGG
TGATACACATTAGGACTGTACCGGCTCTTT|ATTCCTGGCTAGTCCATTTTTATTGCGTGT
AACCGGCTCTTTACATCGTGATACACATTA|GGCTATATTTAGACGCAGGCGCCGTGGCCC
GCGCTTTCAGTGCCACTAGTCCTGCTGTGC|GGTTCCTGGGGTTACAGCTCATGGAGCGTG
AGTTAGTGCCCTGATCGAGAGCAGGTCAAC|CCCTCCTGCATGTATCGATAGTTCTACGGG
ATTTTGGGAATATTTCATGCGTTAATGTCG|TTTACATCGTGATACACATTAGCATCGTGA
GTATGTCAGCATCTTACGGTATCAACTAGT|TACACATTAGCGAGCAACCGGCTCTTTACA
TATTTAGACGCAGGCGCCGTGGCCCACTTC|TCTTCCGGACGGGCAGTTTAACGCTATAAG
AGTACCGGCTCTTTACATCGTGATACACAT|GCCCCACGCTAATGACGATGCGCTGTGGGT
CGGCTCTTTACATCGTGATACACATTAGCA|GCTCTTTACATCGTGATACACATTAGTTTA
ATCTTCCACAGACACGTCTTCCGGACGGGC|GCGAGTGGCGGTAGGTGACCTCACCGGCTC
AGTCTCGTCCCGACTGCGATATGCAACCGG|CTCTTTACATCGTGATACACATTAGTTAGT
GAGACTAGCTAATGATTCCTGGCTAGTCCA|TCAGTGCGTCGCCGAAGCTCCAGTCGGAGA
GTCCTCACTCAGTGCGTCGCCGAAGCTCCA|CTGGCGGCACGCATGTGAAAAAGACTTGGG
TTTGGGAATATTTCATGCGTTAATGTCGGT|TACATCGTGATACACATTAGCATCGTGATA
TGACCATACAGGAGAGGGGGGAGCTGCTTT|CTCTTTACATCGTGATACACATTAGCACCG
CGTCGAGATTTCCCTCCTGCATGTATCGAT|CGACCGTGGGCATGCTATATGTCTCTTAAT
CGGACGGGCAGTTTAACGCTATAAGACTTT|CACCGGCTCTTTACATCGTGATACACAACC
TCCCACCGCAATTGAGCGAGTGGCGGTAGG|ACATCGTGATACACATTAGGACTGTACCGG
GAGTGCTGAGGGCTATATTTAGACGCAGGC|TCTTCCACAGACACGTCTTCCGGACGGGCA
TAGCCGGCTCTTTACATCGTGATACACATT|CCACTTCAGACCGGCTCTTTACATCGTGAT
GGCGCATTTTGGGAATATTTCATGCGTTAA|GGCTCTTTACATCGTGATACACATTAGCAT
GAGCGAGTGGCGGTAGGTGACCTCACCGGC|CATTAGGACTGTACCGGCTCTTTACATCGT
ATCGTGATACACATTAGTTTAGAGAGGCTT|GGGGGAGCTGCTTTCATGCGGTTCAACGAG
GCGACCGGCTCTTTAACCGGCTCTTTACAT|TGCACCGGGTACGACCGGCTCTTTACATCG
TGCCACTAGTCCTGCTGTGCGCCGACCGTG|GTTACAGCTCATGGAGCGTGGCCACTTGCT
CCTGCTGTGCGCCGACCGTGGGCATGCTAT|ATGGAGCGTGGCCACTTGCTTGCCGAGACT
TTAGGATCGGCTCGGTTAAGGATTGTAGAC|CTTTCAGTGCCACTAGTCCTGCTGTGCGCC
ACGCTAATGACGATGCGCTGTGGGTTTTGA|TTATAGAGGTTTCCGTCGCGGCGATAGACC
AGCTTTATAGAGGTTTCCGTCGCGGCGATA|CAGCATCTTACGGTATCAACTAGTGTCTTC
TCGATTATTATCAGGCGTCGCTAATCGTTC|TATCCGATCGGCGCATTTTGGGAATATTTC
ACCGGCTCTTTACATCGTGATACACATTAG|TCTTTACATCGTGATACACATTAGGTGCGA
CATCTCCCGCCCCACGCTAATGACGATGCG|GCGACTAGTAGCTTTATAGAGGTTTCCGTC
TGTTTGTCTCTTAGAGCGCTTTCAGTGCCA|GTTCAGTTTTACCGGGGTTCCTGGGGTTAC
GACCGGCTCTTTAACCGGCTCTTTACATCG|CACCGGGTACGACCGGCTCTTTACATCGTG
CATGCTATATGTCTCTTAATCCGCGTCCTC|CCGAGACTTATCTTGGAGGTCTCACTGGCG
GATACACATTAGCGAGCAACCGGCTCTTTA|GGCTTCAGAGTGCTGAGGGCTATATTTAGA
TAGGTGACCTCACCGGCTCTTTACATCGTG|CCGGCTCTTTACATCGTGATACACATTAGG
GTCTCTTAATCCGCGTCCTCACTCAGTGCG|TCTTGGAGGTCTCACTGGCGGCACGCATGT
ACCTTCACCTACTTACCCTCCGCATCTCCC|GCTAATCGTTCCAGGCAATCAGGCGACTAG
CCTGCATGTATCGATAGTTCTACGGGGGAG|TATATGTCTCTTAATCCGCGTCCTCACTCA
CATCGTGATACACATTAGGACTGTACCGGC|TAATGATTCCTGGCTAGTCCATTTTTATTG
CGAGTGGCGGTAGGTGACCTCACCGGCTCT|TAGGACTGTACCGGCTCTTTACATCGTGAT
CGAGCAACCGGCTCTTTACATCGTGATACA|CTGAGGGCTATATTTAGACGCAGGCGCCGT
TCGGTATGTCAGCATCTTACGGTATCAACT|TGATACACATTAGCGAGCAACCGGCTCTTT
CACAACCGGCTCTTTACATCGTGATACACA|GGCTCGGTTAAGGATTGTAGACGTCGAGAT
TTAGGACTGTACCGGCTCTTTACATCGTGA|TAGTCCATTTTTATTGCGTGTTTGTCTCTT
CACTTCCCGTGGCGACCGGCTCTTTAACCG|ACACATTAGCATGCACCGGGTACGACCGGC
CAGCATCTTACGGTATCAACTAGTGTCTTC|TTAGCGAGCAACCGGCTCTTTACATCGTGA
AGAGTGCTGAGGGCTATATTTAGACGCAGG|ATCTTCCACAGACACGTCTTCCGGACGGGC
GTTAGTGCCCTGATCGAGAGCAGGTCAACC|CCTCCTGCATGTATCGATAGTTCTACGGGG
TCCAGGCAATCAGGCGACTAGTAGCTTTAT|TCATGCGTTAATGTCGGTATGTCAGCATCT
GTAGCTTTATAGAGGTTTCCGTCGCGGCGA|GTCAGCATCTTACGGTATCAACTAGTGTCT
ACATTAGGACTGTACCGGCTCTTTACATCG|GGCTAGTCCATTTTTATTGCGTGTTTGTCT
CCACTAGTCCTGCTGTGCGCCGACCGTGGG|TACAGCTCATGGAGCGTGGCCACTTGCTTG
GACGGGCAGTTTAACGCTATAAGACTTTTC|CCGGCTCTTTACATCGTGATACACAACCGG
CTGTACCGGCTCTTTACATCGTGATACACA|ATTTTTATTGCGTGTTTGTCTCTTAGAGCG
GCAATTGAGCGAGTGGCGGTAGGTGACCTC|GATACACATTAGGACTGTACCGGCTCTTTA
ATGCAACCGGCTCTTTACATCGTGATACAC|ATTAGTTAGTGCCCTGATCGAGAGCAGGTC
TGACGATGCGCTGTGGGTTTTGAGCTCCAA|GGTTTCCGTCGCGGCGATAGACCGGCTCTT
CCTCAGTACCGGCTCTTTACATCGTGATAC|TCCCGCCCCACGCTAATGACGATGCGCTGT
GCGTCGCTAATCGTTCCAGGCAATCAGGCG|ATTTTGGGAATATTTCATGCGTTAATGTCG
TTACATCGTGATACACATTAGGTGCGAGAG|GATACACATTAGGTATGAGCCGACTCGCTC
TGATGAGACAGTTCGTGCAGTGCAGATGTC|ACACATTAGCCGGCTCTTTACATCGTGATA
CTTCACCTCCAGCATATACCTTCACCTACT|GATTATTATCAGGCGTCGCTAATCGTTCCA
GCAACCGGCTCTTTACATCGTGATACACAT|AGGGCTATATTTAGACGCAGGCGCCGTGGC
ATACACATTAGGTATGAGCCGACTCGCTCA|GTGCAGATGTCACTTCCCGTGGCGACCGGC
ACAGACACGTCTTCCGGACGGGCAGTTTAA|GCGGTAGGTGACCTCACCGGCTCTTTACAT
AGCCGGCTCTTTACATCGTGATACACATTA|CACTTCAGACCGGCTCTTTACATCGTGATA
AAGACTTTTCAGTCTCGTCCCGACTGCGAT|ACACAACCGGCTCTTTACATCGTGATACAC
GAGCTGCTTTCATGCGGTTCAACGAGGATC|ATTAGCACCGGCTCCCACCGCAATTGAGCG
CTGCTTTCATGCGGTTCAACGAGGATCTTC|AGCACCGGCTCCCACCGCAATTGAGCGAGT
CCGGCTCTTTACATCGTGATACACATTAGG|CTTTACATCGTGATACACATTAGGTGCGAG
CCTCCAGCATATACCTTCACCTACTTACCC|TTATCAGGCGTCGCTAATCGTTCCAGGCAA
GGTTCAACGAGGATCTTCCACAGACACGTC|CACCGCAATTGAGCGAGTGGCGGTAGGTGA
GTGTCTTCATGATGAGACAGTTCGTGCAGT|CATCGTGATACACATTAGCCGGCTCTTTAC
GCATCTCCCGCCCCACGCTAATGACGATGC|GGCGACTAGTAGCTTTATAGAGGTTTCCGT
CACATTAGGTATGAGCCGACTCGCTCATAT|CAGATGTCACTTCCCGTGGCGACCGGCTCT
CTTTACATCGTGATACACATTAGGACTGTA|CTAGCTAATGATTCCTGGCTAGTCCATTTT
GGCTCCCACCGCAATTGAGCGAGTGGCGGT|TTTACATCGTGATACACATTAGGACTGTAC
TCCTCACTCAGTGCGTCGCCGAAGCTCCAG|TGGCGGCACGCATGTGAAAAAGACTTGGGA
GGCGATAGACCGGCTCTTTACATCGTGATA|TGTCTTCATGATGAGACAGTTCGTGCAGTG
GCCGACCGTGGGCATGCTATATGTCTCTTA|GCCACTTGCTTGCCGAGACTTATCTTGGAG
GAGAGATCGATTATTATCAGGCGTCGCTAA|CGCTCATATCCGATCGGCGCATTTTGGGAA
ACATCGTGATACACATTAGCACCGGCTCCC|ATCGAGAGCAGGTCAACCGGCTCTTTACAT
GATACACATTAGACCGGTGACCATACAGGA|CTGCGATATGCAACCGGCTCTTTACATCGT
TGCACCGGGTACGACCGGCTCTTTACATCG|ATTAGACCGGTGACCATACAGGAGAGGGGG
AACCGGCTCTTTACATCGTGATACACATTA|TCGGTTAAGGATTGTAGACGTCGAGATTTC
CAATTGAGCGAGTGGCGGTAGGTGACCTCA|ATACACATTAGGACTGTACCGGCTCTTTAC
ATATGCAACCGGCTCTTTACATCGTGATAC|ACATTAGTTAGTGCCCTGATCGAGAGCAGG
CGTGATACACATTAGCGAGCAACCGGCTCT|AGAGGCTTCAGAGTGCTGAGGGCTATATTT
TATTTCATGCGTTAATGTCGGTATGTCAGC|GATACACATTAGCATCGTGATACACATTAG
TGTCAGCATCTTACGGTATCAACTAGTGTC|ACATTAGCGAGCAACCGGCTCTTTACATCG
CAGGCGACTAGTAGCTTTATAGAGGTTTCC|ATGTCGGTATGTCAGCATCTTACGGTATCA
ACATTAGCACCGGCTCCCACCGCAATTGAG|TCAACCGGCTCTTTACATCGTGATACACAT
GATACACATTAGGTGCGAGAGATCGATTAT|TAGGTATGAGCCGACTCGCTCATATCCGAT
TTACATCGTGATACACATTAGGGTGTACTT|CGTGATACACATTAGGTGCGAGAGATCGAT
GGTGACCTCACCGGCTCTTTACATCGTGAT|GGCTCTTTACATCGTGATACACATTAGGAT
GAGCAGGTCAACCGGCTCTTTACATCGTGA|TAGTTCTACGGGGGAGACTAGCTAATGATT
TGCAACCGGCTCTTTACATCGTGATACACA|TTAGTTAGTGCCCTGATCGAGAGCAGGTCA
GCGGCGATAGACCGGCTCTTTACATCGTGA|AGTGTCTTCATGATGAGACAGTTCGTGCAG
TACACAACCGGCTCTTTACATCGTGATACA|TCGGCTCGGTTAAGGATTGTAGACGTCGAG
CGACTGCGATATGCAACCGGCTCTTTACAT|CGTGATACACATTAGTTAGTGCCCTGATCG
ATACAGGAGAGGGGGGAGCTGCTTTCATGC|TACATCGTGATACACATTAGCACCGGCTCC
TACATCGTGATACACATTAGGTATGAGCCG|GTTCGTGCAGTGCAGATGTCACTTCCCGTG
TTCAGAGTGCTGAGGGCTATATTTAGACGC|AGGATCTTCCACAGACACGTCTTCCGGACG
CCGGGTACGACCGGCTCTTTACATCGTGAT|GACCGGTGACCATACAGGAGAGGGGGGAGC
GCTCTTTACATCGTGATACACATTAGGTAT|GAGACAGTTCGTGCAGTGCAGATGTCACTT
CAGTGCCACTAGTCCTGCTGTGCGCCGACC|GGGGTTACAGCTCATGGAGCGTGGCCACTT
GCGCCGTGGCCCACTTCAGACCGGCTCTTT|CAGTTTAACGCTATAAGACTTTTCAGTCTC
GCTGAGGGCTATATTTAGACGCAGGCGCCG|CCACAGACACGTCTTCCGGACGGGCAGTTT
CCTGATCGAGAGCAGGTCAACCGGCTCTTT|ATGTATCGATAGTTCTACGGGGGAGACTAG
TCGCTAATCGTTCCAGGCAATCAGGCGACT|TTGGGAATATTTCATGCGTTAATGTCGGTA
TTACATCGTGATACACATTAGTTAGTGCCC|ATTGTAGACGTCGAGATTTCCCTCCTGCAT
TGCTGAGGGCTATATTTAGACGCAGGCGCC|TCCACAGACACGTCTTCCGGACGGGCAGTT
CATCGTGATACACATTAGCATCGTGATACA|TCGTGATACACATTAGTTTAGAGAGGCTTC
CTATATGTCTCTTAATCCGCGTCCTCACTC|GACTTATCTTGGAGGTCTCACTGGCGGCAC
GAGGGGGGAGCTGCTTTCATGCGGTTCAAC|GATACACATTAGCACCGGCTCCCACCGCAA
CTCGGTTAAGGATTGTAGACGTCGAGATTT|CACTAGTCCTGCTGTGCGCCGACCGTGGGC
TCAGTGCCACTAGTCCTGCTGTGCGCCGAC|TGGGGTTACAGCTCATGGAGCGTGGCCACT
ATCCCTCAGTTATACCGGCTCTTTACATCG|AGCTCCAACCGGCTCTTTACATCGTGATAC
TCTTACGGTATCAACTAGTGTCTTCATGAT|GAGCAACCGGCTCTTTACATCGTGATACAC
CGTGATACACATTAGGATCCCTCAGTTATA|TGCGCTGTGGGTTTTGAGCTCCAACCGGCT
ATTAGGGTGTACTTCACCTCCAGCATATAC|TGCGAGAGATCGATTATTATCAGGCGTCGC
GCTCTTTACATCGTGATACACATTAGTTTA|ACAGGAGAGGGGGGAGCTGCTTTCATGCGG
CTCAGTTATACCGGCTCTTTACATCGTGAT|CCAACCGGCTCTTTACATCGTGATACACAT
AGACCGGCTCTTTACATCGTGATACACATT|ACTTTTCAGTCTCGTCCCGACTGCGATATG
TCTTTACATCGTGATACACATTAGTTTAGA|AGGAGAGGGGGGAGCTGCTTTCATGCGGTT
CACGTCTTCCGGACGGGCAGTTTAACGCTA|AGGTGACCTCACCGGCTCTTTACATCGTGA
ACACATTAGGACTGTACCGGCTCTTTACAT|CTGGCTAGTCCATTTTTATTGCGTGTTTGT
CGGTTCAACGAGGATCTTCCACAGACACGT|CCACCGCAATTGAGCGAGTGGCGGTAGGTG
GTTTTGAGCTCCAACCGGCTCTTTACATCG|ATAGACCGGCTCTTTACATCGTGATACACA
CATCGTGATACACATTAGCATGCACCGGGT|CTCTTTACATCGTGATACACATTAGACCGG
CCGCCCCACGCTAATGACGATGCGCTGTGG|AGTAGCTTTATAGAGGTTTCCGTCGCGGCG
GCGGTTCAACGAGGATCTTCCACAGACACG|CCCACCGCAATTGAGCGAGTGGCGGTAGGT
TGTACCGGCTCTTTACATCGTGATACACAT|TTTTTATTGCGTGTTTGTCTCTTAGAGCGC
TATTATCAGGCGTCGCTAATCGTTCCAGGC|GATCGGCGCATTTTGGGAATATTTCATGCG
GTCTCGTCCCGACTGCGATATGCAACCGGC|TCTTTACATCGTGATACACATTAGTTAGTG
GTGGCGGTAGGTGACCTCACCGGCTCTTTA|GACTGTACCGGCTCTTTACATCGTGATACA
TCGTGATACACATTAGGATCGGCTCGGTTA|TCTCTTAGAGCGCTTTCAGTGCCACTAGTC
TCCACAGACACGTCTTCCGGACGGGCAGTT|GTGGCGGTAGGTGACCTCACCGGCTCTTTA
GTTAATGTCGGTATGTCAGCATCTTACGGT|AGCATCGTGATACACATTAGCGAGCAACCG
CTTCCGGACGGGCAGTTTAACGCTATAAGA|ACCTCACCGGCTCTTTACATCGTGATACAC
TTTACATCGTGATACACATTAGACCGGTGA|CTCGTCCCGACTGCGATATGCAACCGGCTC
ACACATTAGCATGCACCGGGTACGACCGGC|TCGTGATACACATTAGACCGGTGACCATAC
TCAGTCTCGTCCCGACTGCGATATGCAACC|GGCTCTTTACATCGTGATACACATTAGTTA
CGGCTCTTTACATCGTGATACACATTAGGA|ATTGCGTGTTTGTCTCTTAGAGCGCTTTCA
GGGTTTTGAGCTCCAACCGGCTCTTTACAT|CGATAGACCGGCTCTTTACATCGTGATACA
ATCGTGATACACATTAGACCGGTGACCATA|CCCGACTGCGATATGCAACCGGCTCTTTAC
CTTTATAGAGGTTTCCGTCGCGGCGATAGA|GCATCTTACGGTATCAACTAGTGTCTTCAT
ATCCGCGTCCTCACTCAGTGCGTCGCCGAA|GTCTCACTGGCGGCACGCATGTGAAAAAGA
AGACTTTTCAGTCTCGTCCCGACTGCGATA|CACAACCGGCTCTTTACATCGTGATACACA
TTCAGTCTCGTCCCGACTGCGATATGCAAC|CGGCTCTTTACATCGTGATACACATTAGTT
TAGGACTGTACCGGCTCTTTACATCGTGAT|AGTCCATTTTTATTGCGTGTTTGTCTCTTA
ATGACGATGCGCTGTGGGTTTTGAGCTCCA|AGGTTTCCGTCGCGGCGATAGACCGGCTCT
ATACACATTAGTTTAGAGAGGCTTCAGAGT|GCTGCTTTCATGCGGTTCAACGAGGATCTT
TATGTCAGCATCTTACGGTATCAACTAGTG|ACACATTAGCGAGCAACCGGCTCTTTACAT
TTATCAGGCGTCGCTAATCGTTCCAGGCAA|TCGGCGCATTTTGGGAATATTTCATGCGTT
ATGAGACAGTTCGTGCAGTGCAGATGTCAC|ACATTAGCCGGCTCTTTACATCGTGATACA
CTTAATCCGCGTCCTCACTCAGTGCGTCGC|GGAGGTCTCACTGGCGGCACGCATGTGAAA
TACCGGCTCTTTACATCGTGATACACATTA|TTTATTGCGTGTTTGTCTCTTAGAGCGCTT
GCAACCGGCTCTTTACATCGTGATACACAT|TAGTTAGTGCCCTGATCGAGAGCAGGTCAA
CCTACTTACCCTCCGCATCTCCCGCCCCAC|GTTCCAGGCAATCAGGCGACTAGTAGCTTT
GACTCGCTCATATCCGATCGGCGCATTTTG|GGCGACCGGCTCTTTAACCGGCTCTTTACA
CCACCGCAATTGAGCGAGTGGCGGTAGGTG|ATCGTGATACACATTAGGACTGTACCGGCT
TACAGGAGAGGGGGGAGCTGCTTTCATGCG|ACATCGTGATACACATTAGCACCGGCTCCC
CTCAGTGCGTCGCCGAAGCTCCAGTCGGAG|CACGCATGTGAAAAAGACTTGGGAACGTCT
CTCATATCCGATCGGCGCATTTTGGGAATA|CGGCTCTTTAACCGGCTCTTTACATCGTGA
GGAGAGGGGGGAGCTGCTTTCATGCGGTTC|CGTGATACACATTAGCACCGGCTCCCACCG
GCTATATGTCTCTTAATCCGCGTCCTCACT|AGACTTATCTTGGAGGTCTCACTGGCGGCA
CCTGGCTAGTCCATTTTTATTGCGTGTTTG|CTCCAGTCGGAGATGACAGGAACGGTTCAG
CTGAGGGCTATATTTAGACGCAGGCGCCGT|CACAGACACGTCTTCCGGACGGGCAGTTTA
AGGGGGGAGCTGCTTTCATGCGGTTCAACG|ATACACATTAGCACCGGCTCCCACCGCAAT
CGTGATACACATTAGGACTGTACCGGCTCT|TGATTCCTGGCTAGTCCATTTTTATTGCGT
TACATCGTGATACACATTAGTTAGTGCCCT|TTGTAGACGTCGAGATTTCCCTCCTGCATG
CGAGATTTCCCTCCTGCATGTATCGATAGT|CCGTGGGCATGCTATATGTCTCTTAATCCG
ATACACATTAGCGAGCAACCGGCTCTTTAC|GCTTCAGAGTGCTGAGGGCTATATTTAGAC
CTTTTCAGTCTCGTCCCGACTGCGATATGC|AACCGGCTCTTTACATCGTGATACACATTA
CTCCCACCGCAATTGAGCGAGTGGCGGTAG|TACATCGTGATACACATTAGGACTGTACCG
GGCTCTTTACATCGTGATACACAACCGGCT|CGTGATACACATTAGGATCGGCTCGGTTAA
ATCGTGATACACAACCGGCTCTTTACATCG|ATTAGGATCGGCTCGGTTAAGGATTGTAGA
GAGCGCTTTCAGTGCCACTAGTCCTGCTGT|GGGGTTCCTGGGGTTACAGCTCATGGAGCG
GCCACTAGTCCTGCTGTGCGCCGACCGTGG|TTACAGCTCATGGAGCGTGGCCACTTGCTT
CTCCAGCATATACCTTCACCTACTTACCCT|TATCAGGCGTCGCTAATCGTTCCAGGCAAT
ACATTAGGTGCGAGAGATCGATTATTATCA|ATGAGCCGACTCGCTCATATCCGATCGGCG
TTAGTTAGTGCCCTGATCGAGAGCAGGTCA|TTCCCTCCTGCATGTATCGATAGTTCTACG
ACACATTAGGATCCCTCAGTTATACCGGCT|GTGGGTTTTGAGCTCCAACCGGCTCTTTAC
ACACATTAGTTTAGAGAGGCTTCAGAGTGC|TGCTTTCATGCGGTTCAACGAGGATCTTCC
TTAACGCTATAAGACTTTTCAGTCTCGTCC|ACATCGTGATACACAACCGGCTCTTTACAT
ACCTCCAGCATATACCTTCACCTACTTACC|ATTATCAGGCGTCGCTAATCGTTCCAGGCA
CGCTTTCAGTGCCACTAGTCCTGCTGTGCG|GTTCCTGGGGTTACAGCTCATGGAGCGTGG
TTCATGCGTTAATGTCGGTATGTCAGCATC|ACACATTAGCATCGTGATACACATTAGCGA
CGGCTCTTTACATCGTGATACACATTAGGA|ACGCTAATGACGATGCGCTGTGGGTTTTGA
CAGATGTCACTTCCCGTGGCGACCGGCTCT|TCGTGATACACATTAGCATGCACCGGGTAC
TACACATTAGCCGGCTCTTTACATCGTGAT|CCGTGGCCCACTTCAGACCGGCTCTTTACA
TGAGGGCTATATTTAGACGCAGGCGCCGTG|ACAGACACGTCTTCCGGACGGGCAGTTTAA
ACGGTATCAACTAGTGTCTTCATGATGAGA|AACCGGCTCTTTACATCGTGATACACATTA
TCTTTACATCGTGATACACATTAGCATGCA|GACCGGCTCTTTACATCGTGATACACATTA
ACATTAGTTAGTGCCCTGATCGAGAGCAGG|GATTTCCCTCCTGCATGTATCGATAGTTCT
ACATTAGTTTAGAGAGGCTTCAGAGTGCTG|CTTTCATGCGGTTCAACGAGGATCTTCCAC
CACTCAGTGCGTCGCCGAAGCTCCAGTCGG|GGCACGCATGTGAAAAAGACTTGGGAACGT
CTCTTTACATCGTGATACACAACCGGCTCT|TGATACACATTAGGATCGGCTCGGTTAAGG
CCAGGCAATCAGGCGACTAGTAGCTTTATA|CATGCGTTAATGTCGGTATGTCAGCATCTT
GACAGTTCGTGCAGTGCAGATGTCACTTCC|TAGCCGGCTCTTTACATCGTGATACACATT
ACGACCGGCTCTTTACATCGTGATACACAT|TGACCATACAGGAGAGGGGGGAGCTGCTTT
GCCGACTCGCTCATATCCGATCGGCGCATT|CGTGGCGACCGGCTCTTTAACCGGCTCTTT
CATTAGTTTAGAGAGGCTTCAGAGTGCTGA|TTTCATGCGGTTCAACGAGGATCTTCCACA
GTGATACACATTAGCATGCACCGGGTACGA|TTACATCGTGATACACATTAGACCGGTGAC
TCTCGTCCCGACTGCGATATGCAACCGGCT|CTTTACATCGTGATACACATTAGTTAGTGC
GCCGTGGCCCACTTCAGACCGGCTCTTTAC|GTTTAACGCTATAAGACTTTTCAGTCTCGT
ACCGGGTACGACCGGCTCTTTACATCGTGA|AGACCGGTGACCATACAGGAGAGGGGGGAG
GCTCTTTACATCGTGATACACATTAGGATC|TGCGTGTTTGTCTCTTAGAGCGCTTTCAGT
CCTCCGCATCTCCCGCCCCACGCTAATGAC|AATCAGGCGACTAGTAGCTTTATAGAGGTT
ATCAGGCGACTAGTAGCTTTATAGAGGTTT|TAATGTCGGTATGTCAGCATCTTACGGTAT
TCTTTACATCGTGATACACATTAGGGTGTA|CATCGTGATACACATTAGGTGCGAGAGATC
GCTTTCAGTGCCACTAGTCCTGCTGTGCGC|TTCCTGGGGTTACAGCTCATGGAGCGTGGC
CACCGGGTACGACCGGCTCTTTACATCGTG|TAGACCGGTGACCATACAGGAGAGGGGGGA
ACCGGCTCTTTACATCGTGATACACATTAG|TTATTGCGTGTTTGTCTCTTAGAGCGCTTT
CCGTGGGCATGCTATATGTCTCTTAATCCG|TTGCTTGCCGAGACTTATCTTGGAGGTCTC
TCAGACCGGCTCTTTACATCGTGATACACA|AGACTTTTCAGTCTCGTCCCGACTGCGATA
CCATTTTTATTGCGTGTTTGTCTCTTAGAG|AGATGACAGGAACGGTTCAGTTTTACCGGG
TTTACATCGTGATACACATTAGGATCCCTC|ATGACGATGCGCTGTGGGTTTTGAGCTCCA
CGCATCTCCCGCCCCACGCTAATGACGATG|AGGCGACTAGTAGCTTTATAGAGGTTTCCG
TACATCGTGATACACATTAGTTTAGAGAGG|GAGGGGGGAGCTGCTTTCATGCGGTTCAAC
TCGTGATACACATTAGGATCCCTCAGTTAT|ATGCGCTGTGGGTTTTGAGCTCCAACCGGC
AATGACGATGCGCTGTGGGTTTTGAGCTCC|GAGGTTTCCGTCGCGGCGATAGACCGGCTC
TTATAGAGGTTTCCGTCGCGGCGATAGACC|ATCTTACGGTATCAACTAGTGTCTTCATGA
CACATTAGTTAGTGCCCTGATCGAGAGCAG|AGATTTCCCTCCTGCATGTATCGATAGTTC
TGGGTTTTGAGCTCCAACCGGCTCTTTACA|GCGATAGACCGGCTCTTTACATCGTGATAC
GTCCCGACTGCGATATGCAACCGGCTCTTT|ACATCGTGATACACATTAGTTAGTGCCCTG
CATCTTACGGTATCAACTAGTGTCTTCATG|GCGAGCAACCGGCTCTTTACATCGTGATAC
GATACACATTAGGATCCCTCAGTTATACCG|GCTGTGGGTTTTGAGCTCCAACCGGCTCTT
CGCAGGCGCCGTGGCCCACTTCAGACCGGC|ACGGGCAGTTTAACGCTATAAGACTTTTCA
TCGTGATACACATTAGTTTAGAGAGGCTTC|GGGGAGCTGCTTTCATGCGGTTCAACGAGG
GGTTTTGAGCTCCAACCGGCTCTTTACATC|GATAGACCGGCTCTTTACATCGTGATACAC
CCAGCATATACCTTCACCTACTTACCCTCC|TCAGGCGTCGCTAATCGTTCCAGGCAATCA
CTTTACATCGTGATACACATTAGGATCGGC|GTGTTTGTCTCTTAGAGCGCTTTCAGTGCC
GATCGAGAGCAGGTCAACCGGCTCTTTACA|TATCGATAGTTCTACGGGGGAGACTAGCTA
TTCACCTACTTACCCTCCGCATCTCCCGCC|AATCGTTCCAGGCAATCAGGCGACTAGTAG
CTCCGCATCTCCCGCCCCACGCTAATGACG|ATCAGGCGACTAGTAGCTTTATAGAGGTTT
TCGTGATACACATTAGACCGGTGACCATAC|CCGACTGCGATATGCAACCGGCTCTTTACA
TGATACACATTAGGTGCGAGAGATCGATTA|TTAGGTATGAGCCGACTCGCTCATATCCGA
GTATCAACTAGTGTCTTCATGATGAGACAG|CGGCTCTTTACATCGTGATACACATTAGCC
TAGCACCGGCTCCCACCGCAATTGAGCGAG|CCGGCTCTTTACATCGTGATACACATTAGG
TATCCGATCGGCGCATTTTGGGAATATTTC|TCTTTAACCGGCTCTTTACATCGTGATACA
GAGGGCTATATTTAGACGCAGGCGCCGTGG|CAGACACGTCTTCCGGACGGGCAGTTTAAC
TTACCCTCCGCATCTCCCGCCCCACGCTAA|AGGCAATCAGGCGACTAGTAGCTTTATAGA
ATCGTGATACACATTAGGACTGTACCGGCT|AATGATTCCTGGCTAGTCCATTTTTATTGC
ACAGTTCGTGCAGTGCAGATGTCACTTCCC|AGCCGGCTCTTTACATCGTGATACACATTA
AGTTCTACGGGGGAGACTAGCTAATGATTC|CCGCGTCCTCACTCAGTGCGTCGCCGAAGC
ATCGTGATACACATTAGCATCGTGATACAC|CGTGATACACATTAGTTTAGAGAGGCTTCA
TAGTTTAGAGAGGCTTCAGAGTGCTGAGGG|CATGCGGTTCAACGAGGATCTTCCACAGAC
CGTGATACACATTAGTTTAGAGAGGCTTCA|GGGAGCTGCTTTCATGCGGTTCAACGAGGA
TAGCTTTATAGAGGTTTCCGTCGCGGCGAT|TCAGCATCTTACGGTATCAACTAGTGTCTT
CATTAGACCGGTGACCATACAGGAGAGGGG|TATGCAACCGGCTCTTTACATCGTGATACA
TGCGTTAATGTCGGTATGTCAGCATCTTAC|ATTAGCATCGTGATACACATTAGCGAGCAA
CACATTAGCCGGCTCTTTACATCGTGATAC|GTGGCCCACTTCAGACCGGCTCTTTACATC
CATTAGGATCGGCTCGGTTAAGGATTGTAG|CGCTTTCAGTGCCACTAGTCCTGCTGTGCG
TTTTGGGAATATTTCATGCGTTAATGTCGG|TTACATCGTGATACACATTAGCATCGTGAT
TGCTTTCATGCGGTTCAACGAGGATCTTCC|GCACCGGCTCCCACCGCAATTGAGCGAGTG
ACACATTAGGATCGGCTCGGTTAAGGATTG|GAGCGCTTTCAGTGCCACTAGTCCTGCTGT
TGATACACATTAGACCGGTGACCATACAGG|ACTGCGATATGCAACCGGCTCTTTACATCG
CGGCTCTTTACATCGTGATACACAACCGGC|TCGTGATACACATTAGGATCGGCTCGGTTA
CAACTAGTGTCTTCATGATGAGACAGTTCG|TCTTTACATCGTGATACACATTAGCCGGCT
ACTTACCCTCCGCATCTCCCGCCCCACGCT|CCAGGCAATCAGGCGACTAGTAGCTTTATA
TAGTGCCCTGATCGAGAGCAGGTCAACCGG|TCCTGCATGTATCGATAGTTCTACGGGGGA
ATAGACCGGCTCTTTACATCGTGATACACA|TTCATGATGAGACAGTTCGTGCAGTGCAGA
TCTTTACATCGTGATACACATTAGGATCGG|CGTGTTTGTCTCTTAGAGCGCTTTCAGTGC
AGGTTTCCGTCGCGGCGATAGACCGGCTCT|CGGTATCAACTAGTGTCTTCATGATGAGAC
TACACATTAGGACTGTACCGGCTCTTTACA|CCTGGCTAGTCCATTTTTATTGCGTGTTTG
GGTTAAGGATTGTAGACGTCGAGATTTCCC|TAGTCCTGCTGTGCGCCGACCGTGGGCATG
TCACCTACTTACCCTCCGCATCTCCCGCCC|ATCGTTCCAGGCAATCAGGCGACTAGTAGC
CTTTAACCGGCTCTTTACATCGTGATACAC|ACGACCGGCTCTTTACATCGTGATACACAT
CCGGCTCTTTACATCGTGATACACATTAGC|CTTCAGACCGGCTCTTTACATCGTGATACA
ATCGGCGCATTTTGGGAATATTTCATGCGT|ACCGGCTCTTTACATCGTGATACACATTAG
GCGTTAATGTCGGTATGTCAGCATCTTACG|TTAGCATCGTGATACACATTAGCGAGCAAC
CTGATCGAGAGCAGGTCAACCGGCTCTTTA|TGTATCGATAGTTCTACGGGGGAGACTAGC
AGCACCGGCTCCCACCGCAATTGAGCGAGT|CGGCTCTTTACATCGTGATACACATTAGGA
TTTACATCGTGATACACATTAGGACTGTAC|TAGCTAATGATTCCTGGCTAGTCCATTTTT
CGTGATACACATTAGTTAGTGCCCTGATCG|GACGTCGAGATTTCCCTCCTGCATGTATCG
ATGTCTCTTAATCCGCGTCCTCACTCAGTG|TATCTTGGAGGTCTCACTGGCGGCACGCAT
GCAGGTCAACCGGCTCTTTACATCGTGATA|GTTCTACGGGGGAGACTAGCTAATGATTCC
ATCAACTAGTGTCTTCATGATGAGACAGTT|GCTCTTTACATCGTGATACACATTAGCCGG
GCTGTGGGTTTTGAGCTCCAACCGGCTCTT|CGCGGCGATAGACCGGCTCTTTACATCGTG
GATAGACCGGCTCTTTACATCGTGATACAC|CTTCATGATGAGACAGTTCGTGCAGTGCAG
TCTTTACATCGTGATACACATTAGGTGCGA|CGTGATACACATTAGGTATGAGCCGACTCG
TACATCGTGATACACATTAGGATCGGCTCG|TTTGTCTCTTAGAGCGCTTTCAGTGCCACT
GAGACAGTTCGTGCAGTGCAGATGTCACTT|ATTAGCCGGCTCTTTACATCGTGATACACA
TACATCGTGATACACATTAGCATGCACCGG|GGCTCTTTACATCGTGATACACATTAGACC
GTGCAGTGCAGATGTCACTTCCCGTGGCGA|TCTTTACATCGTGATACACATTAGCATGCA
CTAGCTTACCTCAGTACCGGCTCTTTACAT|TCCGCATCTCCCGCCCCACGCTAATGACGA
ACCGGCTCTTTACATCGTGATACACATTAG|CGGTTAAGGATTGTAGACGTCGAGATTTCC
TAGTCCTGCTGTGCGCCGACCGTGGGCATG|GCTCATGGAGCGTGGCCACTTGCTTGCCGA
GACGATGCGCTGTGGGTTTTGAGCTCCAAC|GTTTCCGTCGCGGCGATAGACCGGCTCTTT
GGCTCTTTACATCGTGATACACATTAGCCG|ATATTTAGACGCAGGCGCCGTGGCCCACTT
TCAACCGGCTCTTTACATCGTGATACACAT|ACGGGGGAGACTAGCTAATGATTCCTGGCT
GCCCTGATCGAGAGCAGGTCAACCGGCTCT|GCATGTATCGATAGTTCTACGGGGGAGACT
TTACATCGTGATACACATTAGGTATGAGCC|AGTTCGTGCAGTGCAGATGTCACTTCCCGT
TGCCCTGATCGAGAGCAGGTCAACCGGCTC|TGCATGTATCGATAGTTCTACGGGGGAGAC
CATCGTGATACACATTAGGTATGAGCCGAC|TCGTGCAGTGCAGATGTCACTTCCCGTGGC
ACCGGCTCTTTACATCGTGATACACATTAG|TGATGAGACAGTTCGTGCAGTGCAGATGTC
CCACGCTAATGACGATGCGCTGTGGGTTTT|CTTTATAGAGGTTTCCGTCGCGGCGATAGA
TTTTTATTGCGTGTTTGTCTCTTAGAGCGC|TGACAGGAACGGTTCAGTTTTACCGGGGTT
GACTAGCTAATGATTCCTGGCTAGTCCATT|AGTGCGTCGCCGAAGCTCCAGTCGGAGATG
TAGAGAGGCTTCAGAGTGCTGAGGGCTATA|GGTTCAACGAGGATCTTCCACAGACACGTC
TAACGCTATAAGACTTTTCAGTCTCGTCCC|CATCGTGATACACAACCGGCTCTTTACATC
GAGCAACCGGCTCTTTACATCGTGATACAC|TGAGGGCTATATTTAGACGCAGGCGCCGTG
CTCCTGCATGTATCGATAGTTCTACGGGGG|GCTATATGTCTCTTAATCCGCGTCCTCACT
ACATTAGGGTGTACTTCACCTCCAGCATAT|GGTGCGAGAGATCGATTATTATCAGGCGTC
CAGCATATACCTTCACCTACTTACCCTCCG|CAGGCGTCGCTAATCGTTCCAGGCAATCAG
CTTACCCTCCGCATCTCCCGCCCCACGCTA|CAGGCAATCAGGCGACTAGTAGCTTTATAG
TGAGCGAGTGGCGGTAGGTGACCTCACCGG|ACATTAGGACTGTACCGGCTCTTTACATCG
AGCCGACTCGCTCATATCCGATCGGCGCAT|CCGTGGCGACCGGCTCTTTAACCGGCTCTT
CCGGCTCCCACCGCAATTGAGCGAGTGGCG|TCTTTACATCGTGATACACATTAGGACTGT
CCGGTGACCATACAGGAGAGGGGGGAGCTG|CCGGCTCTTTACATCGTGATACACATTAGC
GTCTTCATGATGAGACAGTTCGTGCAGTGC|TCGTGATACACATTAGCCGGCTCTTTACAT
GTTCGTGCAGTGCAGATGTCACTTCCCGTG|CGGCTCTTTACATCGTGATACACATTAGCA
ACATCGTGATACACATTAGTTAGTGCCCTG|TGTAGACGTCGAGATTTCCCTCCTGCATGT
CGGCTCTTTACATCGTGATACACATTAGGG|TTTACATCGTGATACACATTAGGTGCGAGA
CTGCTGTGCGCCGACCGTGGGCATGCTATA|TGGAGCGTGGCCACTTGCTTGCCGAGACTT
GATACACATTAGGTATGAGCCGACTCGCTC|AGTGCAGATGTCACTTCCCGTGGCGACCGG
CGTGATACACATTAGGTATGAGCCGACTCG|TGCAGTGCAGATGTCACTTCCCGTGGCGAC
CAGTTATACCGGCTCTTTACATCGTGATAC|AACCGGCTCTTTACATCGTGATACACATTA
ACTAGTGTCTTCATGATGAGACAGTTCGTG|TTTACATCGTGATACACATTAGCCGGCTCT
GAGGTTTCCGTCGCGGCGATAGACCGGCTC|ACGGTATCAACTAGTGTCTTCATGATGAGA
TCGGCTCGGTTAAGGATTGTAGACGTCGAG|GTGCCACTAGTCCTGCTGTGCGCCGACCGT
TATTGCGTGTTTGTCTCTTAGAGCGCTTTC|AGGAACGGTTCAGTTTTACCGGGGTTCCTG
ATGCGCTGTGGGTTTTGAGCTCCAACCGGC|CCGTCGCGGCGATAGACCGGCTCTTTACAT
ACATTAGCATGCACCGGGTACGACCGGCTC|GTGATACACATTAGACCGGTGACCATACAG
TTTACATCGTGATACACATTAGGTATGAGC|CAGTTCGTGCAGTGCAGATGTCACTTCCCG
GAATATTTCATGCGTTAATGTCGGTATGTC|CGTGATACACATTAGCATCGTGATACACAT
CTAGTAGCTTTATAGAGGTTTCCGTCGCGG|TATGTCAGCATCTTACGGTATCAACTAGTG
CGGCTCTTTACATCGTGATACACATTAGGT|ACATCGTGATACACATTAGGTATGAGCCGA
CGCGTCCTCACTCAGTGCGTCGCCGAAGCT|TCACTGGCGGCACGCATGTGAAAAAGACTT
CATGCGTTAATGTCGGTATGTCAGCATCTT|ACATTAGCATCGTGATACACATTAGCGAGC
TAGGTATGAGCCGACTCGCTCATATCCGAT|GTCACTTCCCGTGGCGACCGGCTCTTTAAC
ATGCACCGGGTACGACCGGCTCTTTACATC|CATTAGACCGGTGACCATACAGGAGAGGGG
GCTCTTTACATCGTGATACACAACCGGCTC|GTGATACACATTAGGATCGGCTCGGTTAAG
CTCTTTACATCGTGATACACATTAGGATCG|GCGTGTTTGTCTCTTAGAGCGCTTTCAGTG
GCATATACCTTCACCTACTTACCCTCCGCA|GGCGTCGCTAATCGTTCCAGGCAATCAGGC
TACACATTAGCGAGCAACCGGCTCTTTACA|CTTCAGAGTGCTGAGGGCTATATTTAGACG
AGTGCAGATGTCACTTCCCGTGGCGACCGG|TACATCGTGATACACATTAGCATGCACCGG
TACACATTAGGGTGTACTTCACCTCCAGCA|TTAGGTGCGAGAGATCGATTATTATCAGGC
ACCGCAATTGAGCGAGTGGCGGTAGGTGAC|CGTGATACACATTAGGACTGTACCGGCTCT
GTGACCTCACCGGCTCTTTACATCGTGATA|GCTCTTTACATCGTGATACACATTAGGATC
GATGCGCTGTGGGTTTTGAGCTCCAACCGG|TCCGTCGCGGCGATAGACCGGCTCTTTACA
CTCTTTACATCGTGATACACATTAGCACCG|GCCCTGATCGAGAGCAGGTCAACCGGCTCT
ACATCGTGATACACATTAGCATGCACCGGG|GCTCTTTACATCGTGATACACATTAGACCG
TATGCAACCGGCTCTTTACATCGTGATACA|CATTAGTTAGTGCCCTGATCGAGAGCAGGT
CTTTCAGTGCCACTAGTCCTGCTGTGCGCC|TCCTGGGGTTACAGCTCATGGAGCGTGGCC
TCCGCATCTCCCGCCCCACGCTAATGACGA|TCAGGCGACTAGTAGCTTTATAGAGGTTTC
ACGATGCGCTGTGGGTTTTGAGCTCCAACC|TTTCCGTCGCGGCGATAGACCGGCTCTTTA
GATCCCTCAGTTATACCGGCTCTTTACATC|GAGCTCCAACCGGCTCTTTACATCGTGATA
TTTACATCGTGATACACATTAGGATCGGCT|TGTTTGTCTCTTAGAGCGCTTTCAGTGCCA
TCCATTTTTATTGCGTGTTTGTCTCTTAGA|GAGATGACAGGAACGGTTCAGTTTTACCGG
CCGCGTCCTCACTCAGTGCGTCGCCGAAGC|CTCACTGGCGGCACGCATGTGAAAAAGACT
GCTTTCATGCGGTTCAACGAGGATCTTCCA|CACCGGCTCCCACCGCAATTGAGCGAGTGG
ACATTAGGTATGAGCCGACTCGCTCATATC|AGATGTCACTTCCCGTGGCGACCGGCTCTT
GAGCCGACTCGCTCATATCCGATCGGCGCA|CCCGTGGCGACCGGCTCTTTAACCGGCTCT
TTTACATCGTGATACACATTAGTTTAGAGA|GAGAGGGGGGAGCTGCTTTCATGCGGTTCA
AGATTTCCCTCCTGCATGTATCGATAGTTC|GTGGGCATGCTATATGTCTCTTAATCCGCG
CCGGCTCTTTACATCGTGATACACAACCGG|ATCGTGATACACATTAGGATCGGCTCGGTT
CGTCCCGACTGCGATATGCAACCGGCTCTT|TACATCGTGATACACATTAGTTAGTGCCCT
CATCGTGATACACATTAGGTGCGAGAGATC|ACACATTAGGTATGAGCCGACTCGCTCATA
AGACGCAGGCGCCGTGGCCCACTTCAGACC|CGGACGGGCAGTTTAACGCTATAAGACTTT
GGCTCTTTACATCGTGATACACATTAGCAT|CTCTTTACATCGTGATACACATTAGTTTAG
ATATACCTTCACCTACTTACCCTCCGCATC|CGTCGCTAATCGTTCCAGGCAATCAGGCGA
GGGAGACTAGCTAATGATTCCTGGCTAGTC|ACTCAGTGCGTCGCCGAAGCTCCAGTCGGA
GGCTATATTTAGACGCAGGCGCCGTGGCCC|ACACGTCTTCCGGACGGGCAGTTTAACGCT
ATACACATTAGCCGGCTCTTTACATCGTGA|GCCGTGGCCCACTTCAGACCGGCTCTTTAC
GGCTCTTTACATCGTGATACACATTAGTTA|TTAAGGATTGTAGACGTCGAGATTTCCCTC
AATGTCGGTATGTCAGCATCTTACGGTATC|ATCGTGATACACATTAGCGAGCAACCGGCT
ATACACATTAGACCGGTGACCATACAGGAG|TGCGATATGCAACCGGCTCTTTACATCGTG
CAACCGGCTCTTTACATCGTGATACACATT|CGGGGGAGACTAGCTAATGATTCCTGGCTA
CGGCTCTTTACATCGTGATACACATTAGTT|GTTAAGGATTGTAGACGTCGAGATTTCCCT
ACACATTAGCATCGTGATACACATTAGCGA|ACATTAGTTTAGAGAGGCTTCAGAGTGCTG
GGTGACCATACAGGAGAGGGGGGAGCTGCT|GGCTCTTTACATCGTGATACACATTAGCAC
GTGATACACATTAGCACCGGCTCCCACCGC|GAGCAGGTCAACCGGCTCTTTACATCGTGA
TGCGAGAGATCGATTATTATCAGGCGTCGC|ACTCGCTCATATCCGATCGGCGCATTTTGG
GCTAATGACGATGCGCTGTGGGTTTTGAGC|ATAGAGGTTTCCGTCGCGGCGATAGACCGG
TCTCCCGCCCCACGCTAATGACGATGCGCT|GACTAGTAGCTTTATAGAGGTTTCCGTCGC
AGAGCAGGTCAACCGGCTCTTTACATCGTG|ATAGTTCTACGGGGGAGACTAGCTAATGAT
TCTTCATGATGAGACAGTTCGTGCAGTGCA|CGTGATACACATTAGCCGGCTCTTTACATC
TACATCGTGATACACATTAGGATCCCTCAG|GACGATGCGCTGTGGGTTTTGAGCTCCAAC
ATCTTACGGTATCAACTAGTGTCTTCATGA|CGAGCAACCGGCTCTTTACATCGTGATACA
TACACATTAGGATCCCTCAGTTATACCGGC|TGTGGGTTTTGAGCTCCAACCGGCTCTTTA
CGCCGTGGCCCACTTCAGACCGGCTCTTTA|AGTTTAACGCTATAAGACTTTTCAGTCTCG
ACCGGCTCTTTAACCGGCTCTTTACATCGT|ACCGGGTACGACCGGCTCTTTACATCGTGA
ATACACATTAGGTGCGAGAGATCGATTATT|AGGTATGAGCCGACTCGCTCATATCCGATC
AGCTAATGATTCCTGGCTAGTCCATTTTTA|CGTCGCCGAAGCTCCAGTCGGAGATGACAG
GGCTCTTTACATCGTGATACACATTAGCAT|TCAGACCGGCTCTTTACATCGTGATACACA
TGATACACATTAGGATCGGCTCGGTTAAGG|CTTAGAGCGCTTTCAGTGCCACTAGTCCTG
CCACTTCAGACCGGCTCTTTACATCGTGAT|CTATAAGACTTTTCAGTCTCGTCCCGACTG
TGAGCTCCAACCGGCTCTTTACATCGTGAT|ACCGGCTCTTTACATCGTGATACACATTAG
ACCTCAGTACCGGCTCTTTACATCGTGATA|CTCCCGCCCCACGCTAATGACGATGCGCTG
CGTGCAGTGCAGATGTCACTTCCCGTGGCG|CTCTTTACATCGTGATACACATTAGCATGC
GCAGGCGCCGTGGCCCACTTCAGACCGGCT|CGGGCAGTTTAACGCTATAAGACTTTTCAG
TGTCGGTATGTCAGCATCTTACGGTATCAA|CGTGATACACATTAGCGAGCAACCGGCTCT
GTGATACACATTAGGGTGTACTTCACCTCC|CACATTAGGTGCGAGAGATCGATTATTATC
GCAGATGTCACTTCCCGTGGCGACCGGCTC|ATCGTGATACACATTAGCATGCACCGGGTA
CCCGTGGCGACCGGCTCTTTAACCGGCTCT|TTAGCATGCACCGGGTACGACCGGCTCTTT
AGGCAATCAGGCGACTAGTAGCTTTATAGA|TGCGTTAATGTCGGTATGTCAGCATCTTAC
ACGGGGGAGACTAGCTAATGATTCCTGGCT|CCTCACTCAGTGCGTCGCCGAAGCTCCAGT
ACATCGTGATACACATTAGGATCGGCTCGG|TTGTCTCTTAGAGCGCTTTCAGTGCCACTA
CGTGATACACATTAGCATCGTGATACACAT|TGATACACATTAGTTTAGAGAGGCTTCAGA
TACATCGTGATACACAACCGGCTCTTTACA|CACATTAGGATCGGCTCGGTTAAGGATTGT
TAAGGATTGTAGACGTCGAGATTTCCCTCC|TCCTGCTGTGCGCCGACCGTGGGCATGCTA
AGTGCTGAGGGCTATATTTAGACGCAGGCG|CTTCCACAGACACGTCTTCCGGACGGGCAG
TCTCTTAATCCGCGTCCTCACTCAGTGCGT|CTTGGAGGTCTCACTGGCGGCACGCATGTG
TACACATTAGGTATGAGCCGACTCGCTCAT|TGCAGATGTCACTTCCCGTGGCGACCGGCT
CCAACCGGCTCTTTACATCGTGATACACAT|TCTTTACATCGTGATACACATTAGGTATGA
GCGGTAGGTGACCTCACCGGCTCTTTACAT|TGTACCGGCTCTTTACATCGTGATACACAT
AGTAGCTTTATAGAGGTTTCCGTCGCGGCG|TGTCAGCATCTTACGGTATCAACTAGTGTC
CATTAGCATCGTGATACACATTAGCGAGCA|TTAGTTTAGAGAGGCTTCAGAGTGCTGAGG
ATTATTATCAGGCGTCGCTAATCGTTCCAG|CCGATCGGCGCATTTTGGGAATATTTCATG
GCGAGAGATCGATTATTATCAGGCGTCGCT|CTCGCTCATATCCGATCGGCGCATTTTGGG
GACTGTACCGGCTCTTTACATCGTGATACA|CCATTTTTATTGCGTGTTTGTCTCTTAGAG
GCTCCAACCGGCTCTTTACATCGTGATACA|GGCTCTTTACATCGTGATACACATTAGGTA
GAGATCGATTATTATCAGGCGTCGCTAATC|CTCATATCCGATCGGCGCATTTTGGGAATA
CAACCGGCTCTTTACATCGTGATACACATT|AGTTAGTGCCCTGATCGAGAGCAGGTCAAC
AGGCGTCGCTAATCGTTCCAGGCAATCAGG|GCATTTTGGGAATATTTCATGCGTTAATGT
TACATCGTGATACACATTAGACCGGTGACC|CGTCCCGACTGCGATATGCAACCGGCTCTT
TGAGACAGTTCGTGCAGTGCAGATGTCACT|CATTAGCCGGCTCTTTACATCGTGATACAC
TCTTAATCCGCGTCCTCACTCAGTGCGTCG|TGGAGGTCTCACTGGCGGCACGCATGTGAA
TAGTTAGTGCCCTGATCGAGAGCAGGTCAA|TCCCTCCTGCATGTATCGATAGTTCTACGG
TGACCTCACCGGCTCTTTACATCGTGATAC|CTCTTTACATCGTGATACACATTAGGATCG
GTGATACACATTAGGATCCCTCAGTTATAC|GCGCTGTGGGTTTTGAGCTCCAACCGGCTC
AACGAGGATCTTCCACAGACACGTCTTCCG|CAATTGAGCGAGTGGCGGTAGGTGACCTCA
CGGTGACCATACAGGAGAGGGGGGAGCTGC|CGGCTCTTTACATCGTGATACACATTAGCA
TGCGTGTTTGTCTCTTAGAGCGCTTTCAGT|AACGGTTCAGTTTTACCGGGGTTCCTGGGG
ACATCGTGATACACATTAGCCGGCTCTTTA|ACGCAGGCGCCGTGGCCCACTTCAGACCGG
CCCTCAGTTATACCGGCTCTTTACATCGTG|CTCCAACCGGCTCTTTACATCGTGATACAC
CAGGCGTCGCTAATCGTTCCAGGCAATCAG|CGCATTTTGGGAATATTTCATGCGTTAATG
AGAGCGCTTTCAGTGCCACTAGTCCTGCTG|CGGGGTTCCTGGGGTTACAGCTCATGGAGC
CTCTTTACATCGTGATACACATTAGTTTAG|CAGGAGAGGGGGGAGCTGCTTTCATGCGGT
CGTCGCGGCGATAGACCGGCTCTTTACATC|AACTAGTGTCTTCATGATGAGACAGTTCGT
CGTGGGCATGCTATATGTCTCTTAATCCGC|TGCTTGCCGAGACTTATCTTGGAGGTCTCA
ATTAGTTTAGAGAGGCTTCAGAGTGCTGAG|TTCATGCGGTTCAACGAGGATCTTCCACAG
TGTCTCTTAGAGCGCTTTCAGTGCCACTAG|AGTTTTACCGGGGTTCCTGGGGTTACAGCT
AGATCGATTATTATCAGGCGTCGCTAATCG|TCATATCCGATCGGCGCATTTTGGGAATAT
TATCAGGCGTCGCTAATCGTTCCAGGCAAT|CGGCGCATTTTGGGAATATTTCATGCGTTA
TCGTGATACACATTAGGTATGAGCCGACTC|GTGCAGTGCAGATGTCACTTCCCGTGGCGA
TGATTCCTGGCTAGTCCATTTTTATTGCGT|CGAAGCTCCAGTCGGAGATGACAGGAACGG
GCGACTAGTAGCTTTATAGAGGTTTCCGTC|TCGGTATGTCAGCATCTTACGGTATCAACT
CACATTAGGACTGTACCGGCTCTTTACATC|TGGCTAGTCCATTTTTATTGCGTGTTTGTC
ACACATTAGTTAGTGCCCTGATCGAGAGCA|GAGATTTCCCTCCTGCATGTATCGATAGTT
CAACCGGCTCTTTACATCGTGATACACATT|CTTTACATCGTGATACACATTAGGTATGAG
TATAAGACTTTTCAGTCTCGTCCCGACTGC|GATACACAACCGGCTCTTTACATCGTGATA
TCGCTCATATCCGATCGGCGCATTTTGGGA|GACCGGCTCTTTAACCGGCTCTTTACATCG
ACTTCCCGTGGCGACCGGCTCTTTAACCGG|CACATTAGCATGCACCGGGTACGACCGGCT
CAGTGCGTCGCCGAAGCTCCAGTCGGAGAT|CGCATGTGAAAAAGACTTGGGAACGTCTTT
TTAGGGTGTACTTCACCTCCAGCATATACC|GCGAGAGATCGATTATTATCAGGCGTCGCT
ACATCGTGATACACATTAGGTATGAGCCGA|TTCGTGCAGTGCAGATGTCACTTCCCGTGG
GATGAGACAGTTCGTGCAGTGCAGATGTCA|CACATTAGCCGGCTCTTTACATCGTGATAC
CGGGTACGACCGGCTCTTTACATCGTGATA|ACCGGTGACCATACAGGAGAGGGGGGAGCT
CTGGCTAGTCCATTTTTATTGCGTGTTTGT|TCCAGTCGGAGATGACAGGAACGGTTCAGT
ATCGTGATACACATTAGTTAGTGCCCTGAT|TAGACGTCGAGATTTCCCTCCTGCATGTAT
ATTAGCGAGCAACCGGCTCTTTACATCGTG|GAGTGCTGAGGGCTATATTTAGACGCAGGC
TGATCGAGAGCAGGTCAACCGGCTCTTTAC|GTATCGATAGTTCTACGGGGGAGACTAGCT
GTACCGGCTCTTTACATCGTGATACACATT|TTTTATTGCGTGTTTGTCTCTTAGAGCGCT
GCGCTGTGGGTTTTGAGCTCCAACCGGCTC|GTCGCGGCGATAGACCGGCTCTTTACATCG
TTTAGAGAGGCTTCAGAGTGCTGAGGGCTA|GCGGTTCAACGAGGATCTTCCACAGACACG
CGCATTTTGGGAATATTTCATGCGTTAATG|CTCTTTACATCGTGATACACATTAGCATCG
GGATCGGCTCGGTTAAGGATTGTAGACGTC|TCAGTGCCACTAGTCCTGCTGTGCGCCGAC
TTATTGCGTGTTTGTCTCTTAGAGCGCTTT|CAGGAACGGTTCAGTTTTACCGGGGTTCCT
CAGTCTCGTCCCGACTGCGATATGCAACCG|GCTCTTTACATCGTGATACACATTAGTTAG
GGTATGAGCCGACTCGCTCATATCCGATCG|CACTTCCCGTGGCGACCGGCTCTTTAACCG
GGTATGTCAGCATCTTACGGTATCAACTAG|ATACACATTAGCGAGCAACCGGCTCTTTAC
AGTGCCCTGATCGAGAGCAGGTCAACCGGC|CCTGCATGTATCGATAGTTCTACGGGGGAG
ACCTCACCGGCTCTTTACATCGTGATACAC|CTTTACATCGTGATACACATTAGGATCGGC
ATCGTGATACACATTAGGTGCGAGAGATCG|CACATTAGGTATGAGCCGACTCGCTCATAT
TTCCCTCCTGCATGTATCGATAGTTCTACG|GCATGCTATATGTCTCTTAATCCGCGTCCT
AGGTCAACCGGCTCTTTACATCGTGATACA|TCTACGGGGGAGACTAGCTAATGATTCCTG
CGATCGGCGCATTTTGGGAATATTTCATGC|TAACCGGCTCTTTACATCGTGATACACATT
CATTAGCCGGCTCTTTACATCGTGATACAC|GGCCCACTTCAGACCGGCTCTTTACATCGT
TAGTTCTACGGGGGAGACTAGCTAATGATT|TCCGCGTCCTCACTCAGTGCGTCGCCGAAG
GCTCTTTACATCGTGATACACATTAGCCGG|TATTTAGACGCAGGCGCCGTGGCCCACTTC
GGATTGTAGACGTCGAGATTTCCCTCCTGC|TGCTGTGCGCCGACCGTGGGCATGCTATAT
GGAGACTAGCTAATGATTCCTGGCTAGTCC|CTCAGTGCGTCGCCGAAGCTCCAGTCGGAG
TCATGCGTTAATGTCGGTATGTCAGCATCT|CACATTAGCATCGTGATACACATTAGCGAG
TATCGATAGTTCTACGGGGGAGACTAGCTA|TCTTAATCCGCGTCCTCACTCAGTGCGTCG
ACGGGCAGTTTAACGCTATAAGACTTTTCA|CGGCTCTTTACATCGTGATACACAACCGGC
ATCGTTCCAGGCAATCAGGCGACTAGTAGC|ATATTTCATGCGTTAATGTCGGTATGTCAG
TGATACACATTAGCCGGCTCTTTACATCGT|GCGCCGTGGCCCACTTCAGACCGGCTCTTT
ATCGTGATACACATTAGCATGCACCGGGTA|TCTTTACATCGTGATACACATTAGACCGGT
CCCTCCGCATCTCCCGCCCCACGCTAATGA|CAATCAGGCGACTAGTAGCTTTATAGAGGT
AACCGGCTCTTTACATCGTGATACACATTA|GTTAGTGCCCTGATCGAGAGCAGGTCAACC
GGCTCTTTACATCGTGATACACATTAGGTA|TGAGACAGTTCGTGCAGTGCAGATGTCACT
ATACACATTAGCACCGGCTCCCACCGCAAT|CAGGTCAACCGGCTCTTTACATCGTGATAC
CTTACGGTATCAACTAGTGTCTTCATGATG|AGCAACCGGCTCTTTACATCGTGATACACA
GCATGCACCGGGTACGACCGGCTCTTTACA|CACATTAGACCGGTGACCATACAGGAGAGG
ATACACAACCGGCTCTTTACATCGTGATAC|ATCGGCTCGGTTAAGGATTGTAGACGTCGA
AGACCGGTGACCATACAGGAGAGGGGGGAG|CAACCGGCTCTTTACATCGTGATACACATT
CACAGACACGTCTTCCGGACGGGCAGTTTA|GGCGGTAGGTGACCTCACCGGCTCTTTACA
TGATACACATTAGGTATGAGCCGACTCGCT|CAGTGCAGATGTCACTTCCCGTGGCGACCG
TACATCGTGATACACATTAGCCGGCTCTTT|GACGCAGGCGCCGTGGCCCACTTCAGACCG
CGTTAATGTCGGTATGTCAGCATCTTACGG|TAGCATCGTGATACACATTAGCGAGCAACC
ACATCGTGATACACATTAGGATCCCTCAGT|ACGATGCGCTGTGGGTTTTGAGCTCCAACC
GTCGCTAATCGTTCCAGGCAATCAGGCGAC|TTTGGGAATATTTCATGCGTTAATGTCGGT
TTAGAGCGCTTTCAGTGCCACTAGTCCTGC|ACCGGGGTTCCTGGGGTTACAGCTCATGGA
ACAGGAGAGGGGGGAGCTGCTTTCATGCGG|CATCGTGATACACATTAGCACCGGCTCCCA
GGCTCTTTACATCGTGATACACATTAGACC|TCAGTCTCGTCCCGACTGCGATATGCAACC
ACCGGTGACCATACAGGAGAGGGGGGAGCT|ACCGGCTCTTTACATCGTGATACACATTAG
ATACACATTAGGGTGTACTTCACCTCCAGC|ATTAGGTGCGAGAGATCGATTATTATCAGG
GAGAGGCTTCAGAGTGCTGAGGGCTATATT|TTCAACGAGGATCTTCCACAGACACGTCTT
TAGGATCGGCTCGGTTAAGGATTGTAGACG|TTTCAGTGCCACTAGTCCTGCTGTGCGCCG
GACCGGCTCTTTACATCGTGATACACATTA|CTTTTCAGTCTCGTCCCGACTGCGATATGC
TCAGCATCTTACGGTATCAACTAGTGTCTT|ATTAGCGAGCAACCGGCTCTTTACATCGTG
AATCAGGCGACTAGTAGCTTTATAGAGGTT|TTAATGTCGGTATGTCAGCATCTTACGGTA
GTAGGTGACCTCACCGGCTCTTTACATCGT|ACCGGCTCTTTACATCGTGATACACATTAG
TACTTACCCTCCGCATCTCCCGCCCCACGC|TCCAGGCAATCAGGCGACTAGTAGCTTTAT
GTTCAACGAGGATCTTCCACAGACACGTCT|ACCGCAATTGAGCGAGTGGCGGTAGGTGAC
GGTACGACCGGCTCTTTACATCGTGATACA|CGGTGACCATACAGGAGAGGGGGGAGCTGC
CTCTTAGAGCGCTTTCAGTGCCACTAGTCC|TTTACCGGGGTTCCTGGGGTTACAGCTCAT
CCGGCTCTTTACATCGTGATACACATTAGT|GGTTAAGGATTGTAGACGTCGAGATTTCCC
GGGGGAGCTGCTTTCATGCGGTTCAACGAG|ACACATTAGCACCGGCTCCCACCGCAATTG
CAGGTCAACCGGCTCTTTACATCGTGATAC|TTCTACGGGGGAGACTAGCTAATGATTCCT
GCGTCCTCACTCAGTGCGTCGCCGAAGCTC|CACTGGCGGCACGCATGTGAAAAAGACTTG
AGGCTTCAGAGTGCTGAGGGCTATATTTAG|AACGAGGATCTTCCACAGACACGTCTTCCG
TCGGCGCATTTTGGGAATATTTCATGCGTT|CCGGCTCTTTACATCGTGATACACATTAGC
TGTCTCTTAATCCGCGTCCTCACTCAGTGC|ATCTTGGAGGTCTCACTGGCGGCACGCATG
ACATCGTGATACACATTAGTTTAGAGAGGC|AGGGGGGAGCTGCTTTCATGCGGTTCAACG
TGATACACATTAGTTTAGAGAGGCTTCAGA|GAGCTGCTTTCATGCGGTTCAACGAGGATC
TATGTCTCTTAATCCGCGTCCTCACTCAGT|TTATCTTGGAGGTCTCACTGGCGGCACGCA
TAATGACGATGCGCTGTGGGTTTTGAGCTC|AGAGGTTTCCGTCGCGGCGATAGACCGGCT
TTTCAGTCTCGTCCCGACTGCGATATGCAA|CCGGCTCTTTACATCGTGATACACATTAGT
TGATACACATTAGCGAGCAACCGGCTCTTT|AGGCTTCAGAGTGCTGAGGGCTATATTTAG
GGGAATATTTCATGCGTTAATGTCGGTATG|ATCGTGATACACATTAGCATCGTGATACAC
CGGTATCAACTAGTGTCTTCATGATGAGAC|ACCGGCTCTTTACATCGTGATACACATTAG
CACATTAGGATCCCTCAGTTATACCGGCTC|TGGGTTTTGAGCTCCAACCGGCTCTTTACA
ACACATTAGGTGCGAGAGATCGATTATTAT|GTATGAGCCGACTCGCTCATATCCGATCGG
TTAATCCGCGTCCTCACTCAGTGCGTCGCC|GAGGTCTCACTGGCGGCACGCATGTGAAAA
GCTTACCTCAGTACCGGCTCTTTACATCGT|GCATCTCCCGCCCCACGCTAATGACGATGC
CTGTGGGTTTTGAGCTCCAACCGGCTCTTT|GCGGCGATAGACCGGCTCTTTACATCGTGA
TATCAACTAGTGTCTTCATGATGAGACAGT|GGCTCTTTACATCGTGATACACATTAGCCG
CTTTACATCGTGATACACATTAGCACCGGC|CCTGATCGAGAGCAGGTCAACCGGCTCTTT
GGCCCACTTCAGACCGGCTCTTTACATCGT|ACGCTATAAGACTTTTCAGTCTCGTCCCGA
CTTTACATCGTGATACACATTAGGATCCCT|AATGACGATGCGCTGTGGGTTTTGAGCTCC
TGGCCCACTTCAGACCGGCTCTTTACATCG|AACGCTATAAGACTTTTCAGTCTCGTCCCG
GTGATACACATTAGGTGCGAGAGATCGATT|ATTAGGTATGAGCCGACTCGCTCATATCCG
CTTACCTCAGTACCGGCTCTTTACATCGTG|CATCTCCCGCCCCACGCTAATGACGATGCG
CGCGGCGATAGACCGGCTCTTTACATCGTG|TAGTGTCTTCATGATGAGACAGTTCGTGCA
TGGCGACCGGCTCTTTAACCGGCTCTTTAC|CATGCACCGGGTACGACCGGCTCTTTACAT
GCTATAAGACTTTTCAGTCTCGTCCCGACT|GTGATACACAACCGGCTCTTTACATCGTGA
TTTAACGCTATAAGACTTTTCAGTCTCGTC|TACATCGTGATACACAACCGGCTCTTTACA
TTGAGCTCCAACCGGCTCTTTACATCGTGA|GACCGGCTCTTTACATCGTGATACACATTA
TGCGCCGACCGTGGGCATGCTATATGTCTC|GTGGCCACTTGCTTGCCGAGACTTATCTTG
CTTTACATCGTGATACACATTAGGGTGTAC|ATCGTGATACACATTAGGTGCGAGAGATCG
GCACCGGGTACGACCGGCTCTTTACATCGT|TTAGACCGGTGACCATACAGGAGAGGGGGG
TACACATTAGGTGCGAGAGATCGATTATTA|GGTATGAGCCGACTCGCTCATATCCGATCG
AGCGAGTGGCGGTAGGTGACCTCACCGGCT|ATTAGGACTGTACCGGCTCTTTACATCGTG
GGCAATCAGGCGACTAGTAGCTTTATAGAG|GCGTTAATGTCGGTATGTCAGCATCTTACG
CCGACTCGCTCATATCCGATCGGCGCATTT|GTGGCGACCGGCTCTTTAACCGGCTCTTTA
GACCGGCTCTTTACATCGTGATACACATTA|ACCATACAGGAGAGGGGGGAGCTGCTTTCA
CCGGCTCTTTACATCGTGATACACATTAGG|GGGAGACTAGCTAATGATTCCTGGCTAGTC
CAACGAGGATCTTCCACAGACACGTCTTCC|GCAATTGAGCGAGTGGCGGTAGGTGACCTC
GATCGATTATTATCAGGCGTCGCTAATCGT|CATATCCGATCGGCGCATTTTGGGAATATT
TAGTAGCTTTATAGAGGTTTCCGTCGCGGC|ATGTCAGCATCTTACGGTATCAACTAGTGT
TGTCTTCATGATGAGACAGTTCGTGCAGTG|ATCGTGATACACATTAGCCGGCTCTTTACA
ATGTCAGCATCTTACGGTATCAACTAGTGT|CACATTAGCGAGCAACCGGCTCTTTACATC
TGCGCTGTGGGTTTTGAGCTCCAACCGGCT|CGTCGCGGCGATAGACCGGCTCTTTACATC
CTCTTAATCCGCGTCCTCACTCAGTGCGTC|TTGGAGGTCTCACTGGCGGCACGCATGTGA
TAATCCGCGTCCTCACTCAGTGCGTCGCCG|AGGTCTCACTGGCGGCACGCATGTGAAAAA
TTGAGCGAGTGGCGGTAGGTGACCTCACCG|CACATTAGGACTGTACCGGCTCTTTACATC
CCCACGCTAATGACGATGCGCTGTGGGTTT|GCTTTATAGAGGTTTCCGTCGCGGCGATAG
TCTTCCACAGACACGTCTTCCGGACGGGCA|CGAGTGGCGGTAGGTGACCTCACCGGCTCT
CATCGTGATACACATTAGGATCGGCTCGGT|TGTCTCTTAGAGCGCTTTCAGTGCCACTAG
GCGCCGACCGTGGGCATGCTATATGTCTCT|TGGCCACTTGCTTGCCGAGACTTATCTTGG
TAGGATCCCTCAGTTATACCGGCTCTTTAC|TTTGAGCTCCAACCGGCTCTTTACATCGTG
TAATCGTTCCAGGCAATCAGGCGACTAGTA|GAATATTTCATGCGTTAATGTCGGTATGTC
CGCAATTGAGCGAGTGGCGGTAGGTGACCT|TGATACACATTAGGACTGTACCGGCTCTTT
GCTGTGCGCCGACCGTGGGCATGCTATATG|GAGCGTGGCCACTTGCTTGCCGAGACTTAT
GTGATACACATTAGGACTGTACCGGCTCTT|GATTCCTGGCTAGTCCATTTTTATTGCGTG
CACATTAGCATCGTGATACACATTAGCGAG|CATTAGTTTAGAGAGGCTTCAGAGTGCTGA
CAGACCGGCTCTTTACATCGTGATACACAT|GACTTTTCAGTCTCGTCCCGACTGCGATAT
CTTTACATCGTGATACACATTAGCCGGCTC|TTAGACGCAGGCGCCGTGGCCCACTTCAGA
ACTAGTCCTGCTGTGCGCCGACCGTGGGCA|CAGCTCATGGAGCGTGGCCACTTGCTTGCC
CATTAGGTATGAGCCGACTCGCTCATATCC|GATGTCACTTCCCGTGGCGACCGGCTCTTT
ATGCGTTAATGTCGGTATGTCAGCATCTTA|CATTAGCATCGTGATACACATTAGCGAGCA
TCATGCGGTTCAACGAGGATCTTCCACAGA|GGCTCCCACCGCAATTGAGCGAGTGGCGGT
GATCGGCGCATTTTGGGAATATTTCATGCG|AACCGGCTCTTTACATCGTGATACACATTA
TGATACACAACCGGCTCTTTACATCGTGAT|GGATCGGCTCGGTTAAGGATTGTAGACGTC
CTTCCACAGACACGTCTTCCGGACGGGCAG|GAGTGGCGGTAGGTGACCTCACCGGCTCTT
ATTTAGACGCAGGCGCCGTGGCCCACTTCA|CTTCCGGACGGGCAGTTTAACGCTATAAGA
TAGGGTGTACTTCACCTCCAGCATATACCT|CGAGAGATCGATTATTATCAGGCGTCGCTA
ACTAGCTAATGATTCCTGGCTAGTCCATTT|GTGCGTCGCCGAAGCTCCAGTCGGAGATGA
ATATTTAGACGCAGGCGCCGTGGCCCACTT|GTCTTCCGGACGGGCAGTTTAACGCTATAA
CTAATCGTTCCAGGCAATCAGGCGACTAGT|GGAATATTTCATGCGTTAATGTCGGTATGT
CAGGCAATCAGGCGACTAGTAGCTTTATAG|ATGCGTTAATGTCGGTATGTCAGCATCTTA
TTGCGTGTTTGTCTCTTAGAGCGCTTTCAG|GAACGGTTCAGTTTTACCGGGGTTCCTGGG
CGTGATACACATTAGGATCGGCTCGGTTAA|CTCTTAGAGCGCTTTCAGTGCCACTAGTCC
CCGGCTCTTTAACCGGCTCTTTACATCGTG|CCGGGTACGACCGGCTCTTTACATCGTGAT
TACGGGGGAGACTAGCTAATGATTCCTGGC|TCCTCACTCAGTGCGTCGCCGAAGCTCCAG
TCCCGTGGCGACCGGCTCTTTAACCGGCTC|ATTAGCATGCACCGGGTACGACCGGCTCTT
CTAGCTAATGATTCCTGGCTAGTCCATTTT|TGCGTCGCCGAAGCTCCAGTCGGAGATGAC
GGGGGGAGCTGCTTTCATGCGGTTCAACGA|TACACATTAGCACCGGCTCCCACCGCAATT
GGCATGCTATATGTCTCTTAATCCGCGTCC|TGCCGAGACTTATCTTGGAGGTCTCACTGG
ACACATTAGCACCGGCTCCCACCGCAATTG|GGTCAACCGGCTCTTTACATCGTGATACAC
GTGCCCTGATCGAGAGCAGGTCAACCGGCT|CTGCATGTATCGATAGTTCTACGGGGGAGA
CTTTCATGCGGTTCAACGAGGATCTTCCAC|ACCGGCTCCCACCGCAATTGAGCGAGTGGC
TAGTGTCTTCATGATGAGACAGTTCGTGCA|TACATCGTGATACACATTAGCCGGCTCTTT
CTCAGTACCGGCTCTTTACATCGTGATACA|CCCGCCCCACGCTAATGACGATGCGCTGTG
TATACCGGCTCTTTACATCGTGATACACAT|GGCTCTTTACATCGTGATACACATTAGGTG
TTAGGTATGAGCCGACTCGCTCATATCCGA|TGTCACTTCCCGTGGCGACCGGCTCTTTAA
TACACATTAGGATCGGCTCGGTTAAGGATT|AGAGCGCTTTCAGTGCCACTAGTCCTGCTG
TTTACATCGTGATACACATTAGCATGCACC|CCGGCTCTTTACATCGTGATACACATTAGA
TACATCGTGATACACATTAGGACTGTACCG|GCTAATGATTCCTGGCTAGTCCATTTTTAT
CGAGGATCTTCCACAGACACGTCTTCCGGA|ATTGAGCGAGTGGCGGTAGGTGACCTCACC
CTCTTTACATCGTGATACACATTAGCATCG|CTTTACATCGTGATACACATTAGTTTAGAG
AGACAGTTCGTGCAGTGCAGATGTCACTTC|TTAGCCGGCTCTTTACATCGTGATACACAT
TAGAGGTTTCCGTCGCGGCGATAGACCGGC|TTACGGTATCAACTAGTGTCTTCATGATGA
TTCAGACCGGCTCTTTACATCGTGATACAC|AAGACTTTTCAGTCTCGTCCCGACTGCGAT
CACGCTAATGACGATGCGCTGTGGGTTTTG|TTTATAGAGGTTTCCGTCGCGGCGATAGAC
AGATGTCACTTCCCGTGGCGACCGGCTCTT|CGTGATACACATTAGCATGCACCGGGTACG
AGCTGCTTTCATGCGGTTCAACGAGGATCT|TTAGCACCGGCTCCCACCGCAATTGAGCGA
CTTCATGATGAGACAGTTCGTGCAGTGCAG|GTGATACACATTAGCCGGCTCTTTACATCG
TACACATTAGCACCGGCTCCCACCGCAATT|AGGTCAACCGGCTCTTTACATCGTGATACA
TTTATAGAGGTTTCCGTCGCGGCGATAGAC|CATCTTACGGTATCAACTAGTGTCTTCATG
CCGGCTCTTTACATCGTGATACACATTAGG|TACATCGTGATACACATTAGGTATGAGCCG
GGTATCAACTAGTGTCTTCATGATGAGACA|CCGGCTCTTTACATCGTGATACACATTAGC
TTAGTGCCCTGATCGAGAGCAGGTCAACCG|CTCCTGCATGTATCGATAGTTCTACGGGGG
CGACCGGCTCTTTACATCGTGATACACATT|GACCATACAGGAGAGGGGGGAGCTGCTTTC
GGCTCTTTACATCGTGATACACATTAGGAT|CGCTAATGACGATGCGCTGTGGGTTTTGAG
TTCCCGTGGCGACCGGCTCTTTAACCGGCT|CATTAGCATGCACCGGGTACGACCGGCTCT
TTAGCCGGCTCTTTACATCGTGATACACAT|CCCACTTCAGACCGGCTCTTTACATCGTGA
TGCAGATGTCACTTCCCGTGGCGACCGGCT|CATCGTGATACACATTAGCATGCACCGGGT
GTGATACACATTAGCATCGTGATACACATT|GATACACATTAGTTTAGAGAGGCTTCAGAG
TTCCACAGACACGTCTTCCGGACGGGCAGT|AGTGGCGGTAGGTGACCTCACCGGCTCTTT
CGCTATAAGACTTTTCAGTCTCGTCCCGAC|CGTGATACACAACCGGCTCTTTACATCGTG
CCGGCTCTTTACATCGTGATACACATTAGC|TAGTGCCCTGATCGAGAGCAGGTCAACCGG
CCGACCGTGGGCATGCTATATGTCTCTTAA|CCACTTGCTTGCCGAGACTTATCTTGGAGG
CTCCAACCGGCTCTTTACATCGTGATACAC|GCTCTTTACATCGTGATACACATTAGGTAT
CACATTAGCACCGGCTCCCACCGCAATTGA|GTCAACCGGCTCTTTACATCGTGATACACA
CGCTAATCGTTCCAGGCAATCAGGCGACTA|TGGGAATATTTCATGCGTTAATGTCGGTAT
CTCTTTACATCGTGATACACATTAGGACTG|GACTAGCTAATGATTCCTGGCTAGTCCATT
TTAGAGAGGCTTCAGAGTGCTGAGGGCTAT|CGGTTCAACGAGGATCTTCCACAGACACGT
CTAATGATTCCTGGCTAGTCCATTTTTATT|TCGCCGAAGCTCCAGTCGGAGATGACAGGA
TCACCGGCTCTTTACATCGTGATACACAAC|TACATCGTGATACACATTAGGATCGGCTCG
TTTCCCTCCTGCATGTATCGATAGTTCTAC|GGCATGCTATATGTCTCTTAATCCGCGTCC
ACATTAGACCGGTGACCATACAGGAGAGGG|ATATGCAACCGGCTCTTTACATCGTGATAC
TCAACGAGGATCTTCCACAGACACGTCTTC|CGCAATTGAGCGAGTGGCGGTAGGTGACCT
TGGCGGTAGGTGACCTCACCGGCTCTTTAC|ACTGTACCGGCTCTTTACATCGTGATACAC
TTACATCGTGATACACAACCGGCTCTTTAC|ACACATTAGGATCGGCTCGGTTAAGGATTG
TTTGAGCTCCAACCGGCTCTTTACATCGTG|AGACCGGCTCTTTACATCGTGATACACATT
CACATTAGCGAGCAACCGGCTCTTTACATC|TCAGAGTGCTGAGGGCTATATTTAGACGCA
CTAGTGTCTTCATGATGAGACAGTTCGTGC|TTACATCGTGATACACATTAGCCGGCTCTT
GTGATACACATTAGTTTAGAGAGGCTTCAG|GGAGCTGCTTTCATGCGGTTCAACGAGGAT
TCATATCCGATCGGCGCATTTTGGGAATAT|GGCTCTTTAACCGGCTCTTTACATCGTGAT
ATTAGCCGGCTCTTTACATCGTGATACACA|GCCCACTTCAGACCGGCTCTTTACATCGTG
TTTCATGCGGTTCAACGAGGATCTTCCACA|CCGGCTCCCACCGCAATTGAGCGAGTGGCG
TTACATCGTGATACACATTAGACCGGTGAC|TCGTCCCGACTGCGATATGCAACCGGCTCT
ACCGGCTCTTTACATCGTGATACACATTAG|TTAGTGCCCTGATCGAGAGCAGGTCAACCG
CTAGTCCTGCTGTGCGCCGACCGTGGGCAT|AGCTCATGGAGCGTGGCCACTTGCTTGCCG
GCTAGTCCATTTTTATTGCGTGTTTGTCTC|AGTCGGAGATGACAGGAACGGTTCAGTTTT
GGGTGTACTTCACCTCCAGCATATACCTTC|AGAGATCGATTATTATCAGGCGTCGCTAAT
ATCGTGATACACATTAGGTATGAGCCGACT|CGTGCAGTGCAGATGTCACTTCCCGTGGCG
TTACATCGTGATACACATTAGCACCGGCTC|TGATCGAGAGCAGGTCAACCGGCTCTTTAC
CAGGAGAGGGGGGAGCTGCTTTCATGCGGT|ATCGTGATACACATTAGCACCGGCTCCCAC
GAGGATCTTCCACAGACACGTCTTCCGGAC|TTGAGCGAGTGGCGGTAGGTGACCTCACCG
TAGGTGCGAGAGATCGATTATTATCAGGCG|GCCGACTCGCTCATATCCGATCGGCGCATT
CATTAGCATGCACCGGGTACGACCGGCTCT|TGATACACATTAGACCGGTGACCATACAGG
AGTGGCGGTAGGTGACCTCACCGGCTCTTT|GGACTGTACCGGCTCTTTACATCGTGATAC
CATCGTGATACACATTAGGGTGTACTTCAC|GATACACATTAGGTGCGAGAGATCGATTAT
ATTCCTGGCTAGTCCATTTTTATTGCGTGT|AAGCTCCAGTCGGAGATGACAGGAACGGTT
TCAGTTATACCGGCTCTTTACATCGTGATA|CAACCGGCTCTTTACATCGTGATACACATT
GCGTGTTTGTCTCTTAGAGCGCTTTCAGTG|ACGGTTCAGTTTTACCGGGGTTCCTGGGGT
GTACGACCGGCTCTTTACATCGTGATACAC|GGTGACCATACAGGAGAGGGGGGAGCTGCT
TTTAGACGCAGGCGCCGTGGCCCACTTCAG|TTCCGGACGGGCAGTTTAACGCTATAAGAC
ATCTCCCGCCCCACGCTAATGACGATGCGC|CGACTAGTAGCTTTATAGAGGTTTCCGTCG
GACCGTGGGCATGCTATATGTCTCTTAATC|ACTTGCTTGCCGAGACTTATCTTGGAGGTC
ACTTTTCAGTCTCGTCCCGACTGCGATATG|CAACCGGCTCTTTACATCGTGATACACATT
CATGATGAGACAGTTCGTGCAGTGCAGATG|ATACACATTAGCCGGCTCTTTACATCGTGA
ACCGGCTCCCACCGCAATTGAGCGAGTGGC|CTCTTTACATCGTGATACACATTAGGACTG
CTTTACATCGTGATACACATTAGCATCGTG|TTACATCGTGATACACATTAGTTTAGAGAG
TAGACGTCGAGATTTCCCTCCTGCATGTAT|GCGCCGACCGTGGGCATGCTATATGTCTCT
GTCCATTTTTATTGCGTGTTTGTCTCTTAG|GGAGATGACAGGAACGGTTCAGTTTTACCG
TGATACACATTAGCACCGGCTCCCACCGCA|AGCAGGTCAACCGGCTCTTTACATCGTGAT
GGCGACTAGTAGCTTTATAGAGGTTTCCGT|GTCGGTATGTCAGCATCTTACGGTATCAAC
CTGCATGTATCGATAGTTCTACGGGGGAGA|ATATGTCTCTTAATCCGCGTCCTCACTCAG
TTACATCGTGATACACATTAGGACTGTACC|AGCTAATGATTCCTGGCTAGTCCATTTTTA
GATACACATTAGCATGCACCGGGTACGACC|ACATCGTGATACACATTAGACCGGTGACCA
TTACATCGTGATACACATTAGTTTAGAGAG|AGAGGGGGGAGCTGCTTTCATGCGGTTCAA
CTCTTTACATCGTGATACACATTAGGATCC|CTAATGACGATGCGCTGTGGGTTTTGAGCT
TCTTTACATCGTGATACACATTAGGACTGT|ACTAGCTAATGATTCCTGGCTAGTCCATTT
GGATCTTCCACAGACACGTCTTCCGGACGG|GAGCGAGTGGCGGTAGGTGACCTCACCGGC
CGATAGACCGGCTCTTTACATCGTGATACA|TCTTCATGATGAGACAGTTCGTGCAGTGCA
TATAGAGGTTTCCGTCGCGGCGATAGACCG|TCTTACGGTATCAACTAGTGTCTTCATGAT
TTTATTGCGTGTTTGTCTCTTAGAGCGCTT|ACAGGAACGGTTCAGTTTTACCGGGGTTCC
CATTAGGGTGTACTTCACCTCCAGCATATA|GTGCGAGAGATCGATTATTATCAGGCGTCG
CGTGGCCCACTTCAGACCGGCTCTTTACAT|TTAACGCTATAAGACTTTTCAGTCTCGTCC
TGAGCCGACTCGCTCATATCCGATCGGCGC|TCCCGTGGCGACCGGCTCTTTAACCGGCTC
ATCGATAGTTCTACGGGGGAGACTAGCTAA|CTTAATCCGCGTCCTCACTCAGTGCGTCGC
GTGGGTTTTGAGCTCCAACCGGCTCTTTAC|GGCGATAGACCGGCTCTTTACATCGTGATA
TCATGATGAGACAGTTCGTGCAGTGCAGAT|GATACACATTAGCCGGCTCTTTACATCGTG
TTAAGGATTGTAGACGTCGAGATTTCCCTC|GTCCTGCTGTGCGCCGACCGTGGGCATGCT
ACGTCTTCCGGACGGGCAGTTTAACGCTAT|GGTGACCTCACCGGCTCTTTACATCGTGAT
TCAGGCGTCGCTAATCGTTCCAGGCAATCA|GCGCATTTTGGGAATATTTCATGCGTTAAT
TTAACCGGCTCTTTACATCGTGATACACAT|GACCGGCTCTTTACATCGTGATACACATTA
GCTTTATAGAGGTTTCCGTCGCGGCGATAG|AGCATCTTACGGTATCAACTAGTGTCTTCA
AGTCCATTTTTATTGCGTGTTTGTCTCTTA|CGGAGATGACAGGAACGGTTCAGTTTTACC
ACATTAGCGAGCAACCGGCTCTTTACATCG|CAGAGTGCTGAGGGCTATATTTAGACGCAG
GAGAGGGGGGAGCTGCTTTCATGCGGTTCA|GTGATACACATTAGCACCGGCTCCCACCGC
AGTTTAACGCTATAAGACTTTTCAGTCTCG|TTTACATCGTGATACACAACCGGCTCTTTA
CGCTCATATCCGATCGGCGCATTTTGGGAA|ACCGGCTCTTTAACCGGCTCTTTACATCGT
ACTAGTAGCTTTATAGAGGTTTCCGTCGCG|GTATGTCAGCATCTTACGGTATCAACTAGT
ACATCGTGATACACATTAGGGTGTACTTCA|TGATACACATTAGGTGCGAGAGATCGATTA
GCTAATCGTTCCAGGCAATCAGGCGACTAG|GGGAATATTTCATGCGTTAATGTCGGTATG
GGCTCTTTAACCGGCTCTTTACATCGTGAT|GGGTACGACCGGCTCTTTACATCGTGATAC
AGTTCGTGCAGTGCAGATGTCACTTCCCGT|CCGGCTCTTTACATCGTGATACACATTAGC
TACACATTAGTTAGTGCCCTGATCGAGAGC|CGAGATTTCCCTCCTGCATGTATCGATAGT
CTGCGATATGCAACCGGCTCTTTACATCGT|GATACACATTAGTTAGTGCCCTGATCGAGA
AACCGGCTCTTTACATCGTGATACACATTA|CCGGCTCTTTACATCGTGATACACATTAGT
GCTCTTTACATCGTGATACACATTAGGACT|AGACTAGCTAATGATTCCTGGCTAGTCCAT
CAACCGGCTCTTTACATCGTGATACACATT|CTCGGTTAAGGATTGTAGACGTCGAGATTT
GACGCAGGCGCCGTGGCCCACTTCAGACCG|GGACGGGCAGTTTAACGCTATAAGACTTTT
GGGGAGCTGCTTTCATGCGGTTCAACGAGG|CACATTAGCACCGGCTCCCACCGCAATTGA
TACATCGTGATACACATTAGGGTGTACTTC|GTGATACACATTAGGTGCGAGAGATCGATT
TATGAGCCGACTCGCTCATATCCGATCGGC|CTTCCCGTGGCGACCGGCTCTTTAACCGGC
TCTTTACATCGTGATACACATTAGTTAGTG|AGGATTGTAGACGTCGAGATTTCCCTCCTG
CACATTAGACCGGTGACCATACAGGAGAGG|GATATGCAACCGGCTCTTTACATCGTGATA
CAACCGGCTCTTTACATCGTGATACACATT|GGGCTATATTTAGACGCAGGCGCCGTGGCC
AGACTAGCTAATGATTCCTGGCTAGTCCAT|CAGTGCGTCGCCGAAGCTCCAGTCGGAGAT
AGAGAGGCTTCAGAGTGCTGAGGGCTATAT|GTTCAACGAGGATCTTCCACAGACACGTCT
GGATCCCTCAGTTATACCGGCTCTTTACAT|TGAGCTCCAACCGGCTCTTTACATCGTGAT
GATAGTTCTACGGGGGAGACTAGCTAATGA|AATCCGCGTCCTCACTCAGTGCGTCGCCGA
CTCTTTACATCGTGATACACATTAGGTATG|AGACAGTTCGTGCAGTGCAGATGTCACTTC
AGCGAGCAACCGGCTCTTTACATCGTGATA|TGCTGAGGGCTATATTTAGACGCAGGCGCC
CTTCCCGTGGCGACCGGCTCTTTAACCGGC|ACATTAGCATGCACCGGGTACGACCGGCTC
CCTCACTCAGTGCGTCGCCGAAGCTCCAGT|GGCGGCACGCATGTGAAAAAGACTTGGGAA
CAGTTCGTGCAGTGCAGATGTCACTTCCCG|GCCGGCTCTTTACATCGTGATACACATTAG
AGTGCGTCGCCGAAGCTCCAGTCGGAGATG|GCATGTGAAAAAGACTTGGGAACGTCTTTG
GATACACATTAGCATCGTGATACACATTAG|TACACATTAGTTTAGAGAGGCTTCAGAGTG
TTACATCGTGATACACATTAGGATCGGCTC|GTTTGTCTCTTAGAGCGCTTTCAGTGCCAC
CGGCTCTTTACATCGTGATACACATTAGGT|ATGAGACAGTTCGTGCAGTGCAGATGTCAC
ATCGATTATTATCAGGCGTCGCTAATCGTT|ATATCCGATCGGCGCATTTTGGGAATATTT
CATGCACCGGGTACGACCGGCTCTTTACAT|ACATTAGACCGGTGACCATACAGGAGAGGG
TACACATTAGTTTAGAGAGGCTTCAGAGTG|CTGCTTTCATGCGGTTCAACGAGGATCTTC
TTTACATCGTGATACACATTAGCCGGCTCT|TAGACGCAGGCGCCGTGGCCCACTTCAGAC
TCAGTACCGGCTCTTTACATCGTGATACAC|CCGCCCCACGCTAATGACGATGCGCTGTGG
CCGCAATTGAGCGAGTGGCGGTAGGTGACC|GTGATACACATTAGGACTGTACCGGCTCTT
GGTGCGAGAGATCGATTATTATCAGGCGTC|CGACTCGCTCATATCCGATCGGCGCATTTT
TTCATGATGAGACAGTTCGTGCAGTGCAGA|TGATACACATTAGCCGGCTCTTTACATCGT
CGATAGTTCTACGGGGGAGACTAGCTAATG|TAATCCGCGTCCTCACTCAGTGCGTCGCCG
AGAGGGGGGAGCTGCTTTCATGCGGTTCAA|TGATACACATTAGCACCGGCTCCCACCGCA
CGATTATTATCAGGCGTCGCTAATCGTTCC|ATCCGATCGGCGCATTTTGGGAATATTTCA
CGTGATACACATTAGACCGGTGACCATACA|CGACTGCGATATGCAACCGGCTCTTTACAT
GGCTCTTTACATCGTGATACACATTAGGAC|GAGACTAGCTAATGATTCCTGGCTAGTCCA
CGGTTAAGGATTGTAGACGTCGAGATTTCC|CTAGTCCTGCTGTGCGCCGACCGTGGGCAT
AGCGCTTTCAGTGCCACTAGTCCTGCTGTG|GGGTTCCTGGGGTTACAGCTCATGGAGCGT
GACGTCGAGATTTCCCTCCTGCATGTATCG|GCCGACCGTGGGCATGCTATATGTCTCTTA
ACACATTAGCGAGCAACCGGCTCTTTACAT|TTCAGAGTGCTGAGGGCTATATTTAGACGC
TCGTTCCAGGCAATCAGGCGACTAGTAGCT|TATTTCATGCGTTAATGTCGGTATGTCAGC
GCATCTTACGGTATCAACTAGTGTCTTCAT|AGCGAGCAACCGGCTCTTTACATCGTGATA
CCGTGGCCCACTTCAGACCGGCTCTTTACA|TTTAACGCTATAAGACTTTTCAGTCTCGTC
TCCCTCCTGCATGTATCGATAGTTCTACGG|CATGCTATATGTCTCTTAATCCGCGTCCTC
GATATGCAACCGGCTCTTTACATCGTGATA|CACATTAGTTAGTGCCCTGATCGAGAGCAG
GGCTCTTTACATCGTGATACACATTAGGAT|TTGCGTGTTTGTCTCTTAGAGCGCTTTCAG
TCAACTAGTGTCTTCATGATGAGACAGTTC|CTCTTTACATCGTGATACACATTAGCCGGC
CCGTGGCGACCGGCTCTTTAACCGGCTCTT|TAGCATGCACCGGGTACGACCGGCTCTTTA
CGGCTCTTTACATCGTGATACACATTAGCA|AGTGCCCTGATCGAGAGCAGGTCAACCGGC
AGGTGACCTCACCGGCTCTTTACATCGTGA|CGGCTCTTTACATCGTGATACACATTAGGA
CATCGTGATACACATTAGCCGGCTCTTTAC|CGCAGGCGCCGTGGCCCACTTCAGACCGGC
TAGCATCGTGATACACATTAGCGAGCAACC|GTTTAGAGAGGCTTCAGAGTGCTGAGGGCT
GGCTAGTCCATTTTTATTGCGTGTTTGTCT|CAGTCGGAGATGACAGGAACGGTTCAGTTT
ATACCGGCTCTTTACATCGTGATACACATT|GCTCTTTACATCGTGATACACATTAGGTGC
CGTGATACACAACCGGCTCTTTACATCGTG|TAGGATCGGCTCGGTTAAGGATTGTAGACG